name1,grass_pts_served1,grass_service_pts_won1,grass_pts_received1,grass_receiving_pts_won1,grass_aces1,hard_pts_served1,hard_service_pts_won1,hard_pts_received1,hard_receiving_pts_won1,hard_aces1,clay_pts_served1,clay_service_pts_won1,clay_pts_received1,clay_receiving_pts_won1,clay_aces1,name2,grass_pts_served2,grass_service_pts_won2,grass_pts_received2,grass_receiving_pts_won2,grass_aces2,hard_pts_served2,hard_service_pts_won2,hard_pts_received2,hard_receiving_pts_won2,hard_aces2,clay_pts_served2,clay_service_pts_won2,clay_pts_received2,clay_receiving_pts_won2,clay_aces2,grass_sample_size,hard_sample_size,clay_sample_size
Rafael Nadal,0,0,0,0,0,128,88,135,56,5,78,55,78,36,1,Kei Nishikori,0,0,0,0,0,135,79,128,40,3,78,42,78,23,0,0,2,1
Grigor Dimitrov,0,0,0,0,0,53,30,48,11,7,0,0,0,0,0,Roberto Bautista Agut,0,0,0,0,0,48,37,53,23,1,0,0,0,0,0,0,1,0
Andy Murray,0,0,0,0,0,0,0,0,0,0,0,0,0,0,0,Stephane Robert,0,0,0,0,0,0,0,0,0,0,0,0,0,0,0,0,0,0
Roger Federer,137,104,145,42,17,638,448,639,225,42,166,98,129,42,2,Jo-Wilfried Tsonga,145,103,137,33,18,639,414,638,190,59,129,87,166,68,5,1,8,2
Tomas Berdych,124,81,121,43,11,368,253,376,146,32,347,238,328,115,36,Kevin Anderson,121,78,124,43,19,376,230,368,115,52,328,213,347,109,46,1,4,4
David Ferrer,0,0,0,0,0,155,101,136,52,6,0,0,0,0,0,Florian Mayer,0,0,0,0,0,136,84,155,54,12,0,0,0,0,0,0,2,0
Stan Wawrinka,0,0,0,0,0,99,58,102,38,11,70,39,84,36,1,Tommy Robredo,0,0,0,0,0,102,64,99,41,7,84,48,70,31,3,0,1,1
Novak Djokovic,86,63,102,44,11,124,89,152,72,12,40,32,40,22,3,Fabio Fognini,102,58,86,23,4,152,80,124,35,4,40,18,40,8,1,1,2,2
Rafael Nadal,0,0,0,0,0,87,56,83,33,4,87,53,71,26,2,Grigor Dimitrov,0,0,0,0,0,83,50,87,31,12,71,45,87,34,8,0,1,1
Roger Federer,209,131,244,88,21,374,237,346,117,15,0,0,0,0,0,Andy Murray,244,156,209,78,21,346,229,374,137,38,0,0,0,0,0,2,4,0
Tomas Berdych,0,0,0,0,0,218,146,240,89,28,0,0,0,0,0,David Ferrer,0,0,0,0,0,240,151,218,72,10,0,0,0,0,0,0,4,0
Stan Wawrinka,0,0,0,0,0,575,335,513,174,36,138,80,122,33,11,Novak Djokovic,0,0,0,0,0,513,339,575,240,24,122,89,138,58,9,0,5,2
Rafael Nadal,0,0,0,0,0,485,322,525,202,11,290,185,282,128,6,Roger Federer,0,0,0,0,0,525,323,485,163,43,282,154,290,105,14,0,7,3
Stan Wawrinka,0,0,0,0,0,365,245,360,144,41,88,56,79,25,5,Tomas Berdych,0,0,0,0,0,360,216,365,120,23,79,54,88,32,8,0,5,1
Stan Wawrinka,0,0,0,0,0,135,90,162,52,9,211,116,178,45,13,Rafael Nadal,0,0,0,0,0,162,110,135,45,4,178,133,211,95,12,0,2,3
Alexandr Dolgopolov,0,0,0,0,0,0,0,0,0,0,56,39,62,26,1,Fabio Fognini,0,0,0,0,0,0,0,0,0,0,62,36,56,17,1,0,0,1
Milos Raonic,0,0,0,0,0,198,128,186,54,27,69,51,71,25,14,Andy Murray,0,0,0,0,0,186,132,198,70,17,71,46,69,18,3,0,4,1
Kevin Anderson,0,0,0,0,0,216,140,164,44,27,0,0,0,0,0,Stan Wawrinka,0,0,0,0,0,164,120,216,76,17,0,0,0,0,0,0,2,0
Roger Federer,162,108,155,52,22,100,61,93,36,10,0,0,0,0,0,Tommy Haas,155,103,162,54,11,93,57,100,39,10,0,0,0,0,0,2,1,0
John Isner,0,0,0,0,0,0,0,0,0,0,0,0,0,0,0,Fernando Verdasco,0,0,0,0,0,0,0,0,0,0,0,0,0,0,0,0,0,0
Ernests Gulbis,0,0,0,0,0,40,32,47,24,5,0,0,0,0,0,Roberto Bautista Agut,0,0,0,0,0,47,23,40,8,0,0,0,0,0,0,0,1,0
Julien Benneteau,74,51,58,7,12,179,123,154,62,17,0,0,0,0,0,Feliciano Lopez,58,51,74,23,19,154,92,179,56,14,0,0,0,0,0,1,3,0
Novak Djokovic,0,0,0,0,0,120,86,111,48,8,0,0,0,0,0,Marin Cilic,0,0,0,0,0,111,63,120,34,8,0,0,0,0,0,0,2,0
Alexandr Dolgopolov,0,0,0,0,0,0,0,0,0,0,0,0,0,0,0,Milos Raonic,0,0,0,0,0,0,0,0,0,0,0,0,0,0,0,0,0,0
Roger Federer,0,0,0,0,0,62,42,65,27,7,0,0,0,0,0,Kevin Anderson,0,0,0,0,0,65,38,62,20,9,0,0,0,0,0,0,1,0
John Isner,0,0,0,0,0,98,69,106,39,17,93,50,73,20,6,Ernests Gulbis,0,0,0,0,0,106,67,98,29,8,73,53,93,43,11,0,1,1
Novak Djokovic,0,0,0,0,0,66,52,76,35,13,0,0,0,0,0,Julien Benneteau,0,0,0,0,0,76,41,66,14,5,0,0,0,0,0,0,1,0
Roger Federer,0,0,0,0,0,0,0,0,0,0,0,0,0,0,0,Alexandr Dolgopolov,0,0,0,0,0,0,0,0,0,0,0,0,0,0,0,0,0,0
Novak Djokovic,0,0,0,0,0,311,225,316,108,28,0,0,0,0,0,John Isner,0,0,0,0,0,316,208,311,86,41,0,0,0,0,0,0,4,0
Novak Djokovic,115,76,101,26,9,751,482,753,298,46,325,207,292,112,14,Roger Federer,101,75,115,39,12,753,455,751,269,48,292,180,325,118,33,1,8,3
Rafael Nadal,0,0,0,0,0,79,44,98,47,3,147,98,175,82,5,Fabio Fognini,0,0,0,0,0,98,51,79,35,3,175,93,147,49,3,0,1,2
Milos Raonic,52,32,63,21,5,50,40,54,20,14,0,0,0,0,0,Benjamin Becker,63,42,52,20,7,54,34,50,10,4,0,0,0,0,0,1,1,0
Alexandr Dolgopolov,0,0,0,0,0,114,64,73,15,5,95,58,77,31,11,Stan Wawrinka,0,0,0,0,0,73,58,114,50,14,77,46,95,37,4,0,1,2
Tomas Berdych,0,0,0,0,0,161,106,159,59,13,0,0,0,0,0,John Isner,0,0,0,0,0,159,100,161,55,31,0,0,0,0,0,0,2,0
Roger Federer,0,0,0,0,0,165,116,189,88,15,147,107,149,52,18,Richard Gasquet,0,0,0,0,0,189,101,165,49,9,149,97,147,40,8,0,3,2
Kei Nishikori,75,49,83,37,2,216,108,217,78,6,0,0,0,0,0,David Ferrer,83,46,75,26,5,217,139,216,108,8,0,0,0,0,0,1,3,0
Andy Murray,278,197,333,127,25,67,45,72,31,3,0,0,0,0,0,Jo-Wilfried Tsonga,333,206,278,81,31,72,41,67,22,1,0,0,0,0,0,3,1,0
Novak Djokovic,0,0,0,0,0,0,0,0,0,0,0,0,0,0,0,Tommy Robredo,0,0,0,0,0,0,0,0,0,0,0,0,0,0,0,0,0,0
Rafael Nadal,0,0,0,0,0,96,78,96,37,6,42,29,57,30,4,Milos Raonic,0,0,0,0,0,96,59,96,18,12,57,27,42,13,6,0,2,1
Tomas Berdych,0,0,0,0,0,150,99,128,49,18,0,0,0,0,0,Alexandr Dolgopolov,0,0,0,0,0,128,79,150,51,13,0,0,0,0,0,0,2,0
Kei Nishikori,0,0,0,0,0,65,34,39,6,0,80,50,65,19,1,Roger Federer,0,0,0,0,0,39,33,65,31,5,65,46,80,30,7,0,1,1
Novak Djokovic,170,98,192,69,7,914,566,955,398,45,96,58,98,45,4,Andy Murray,192,123,170,72,15,955,557,914,348,52,98,53,96,38,6,2,9,1
Rafael Nadal,0,0,0,0,0,465,314,485,183,27,105,82,126,52,2,Tomas Berdych,0,0,0,0,0,485,302,465,151,52,126,74,105,23,7,0,6,2
Novak Djokovic,0,0,0,0,0,91,51,82,32,6,0,0,0,0,0,Kei Nishikori,0,0,0,0,0,82,50,91,40,4,0,0,0,0,0,0,1,0
Novak Djokovic,95,64,82,31,7,781,508,859,351,48,600,349,607,244,14,Rafael Nadal,82,51,95,31,5,859,508,781,273,30,607,363,600,251,20,1,8,7
Rafael Nadal,0,0,0,0,0,0,0,0,0,0,0,0,0,0,0,Andreas Seppi,0,0,0,0,0,0,0,0,0,0,0,0,0,0,0,0,0,0
David Ferrer,0,0,0,0,0,246,153,244,107,8,70,47,63,26,2,Grigor Dimitrov,0,0,0,0,0,244,137,246,93,10,63,37,70,23,2,0,3,1
Stan Wawrinka,0,0,0,0,0,175,100,144,57,13,223,154,196,73,14,Nicolas Almagro,0,0,0,0,0,144,87,175,75,10,196,123,223,69,15,0,2,3
Milos Raonic,0,0,0,0,0,0,0,0,0,0,104,74,117,42,13,Tommy Robredo,0,0,0,0,0,0,0,0,0,0,117,75,104,30,9,0,0,1
Jo-Wilfried Tsonga,0,0,0,0,0,57,40,75,33,5,93,55,107,52,7,Fabio Fognini,0,0,0,0,0,75,42,57,17,3,107,55,93,38,0,0,1,1
Roger Federer,0,0,0,0,0,0,0,0,0,0,0,0,0,0,0,Lukas Rosol,0,0,0,0,0,0,0,0,0,0,0,0,0,0,0,0,0,0
Guillermo Garcia Lopez,0,0,0,0,0,48,22,38,6,3,0,0,0,0,0,Tomas Berdych,0,0,0,0,0,38,32,48,26,3,0,0,0,0,0,0,1,0
Novak Djokovic,0,0,0,0,0,0,0,0,0,0,0,0,0,0,0,Pablo Carreno Busta,0,0,0,0,0,0,0,0,0,0,0,0,0,0,0,0,0,0
David Ferrer,0,0,0,0,0,204,123,211,95,12,697,349,718,278,8,Rafael Nadal,0,0,0,0,0,211,116,204,81,6,718,440,697,348,16,0,3,9
Stan Wawrinka,0,0,0,0,0,162,116,152,45,18,0,0,0,0,0,Milos Raonic,0,0,0,0,0,152,107,162,46,28,0,0,0,0,0,0,2,0
Roger Federer,137,104,145,42,17,638,448,639,225,42,166,98,129,42,2,Jo-Wilfried Tsonga,145,103,137,33,18,639,414,638,190,59,129,87,166,68,5,1,8,2
Novak Djokovic,0,0,0,0,0,0,0,0,0,0,34,32,37,18,5,Guillermo Garcia Lopez,0,0,0,0,0,0,0,0,0,0,37,19,34,2,3,0,0,1
Stan Wawrinka,0,0,0,0,0,231,143,244,100,27,116,74,131,52,6,David Ferrer,0,0,0,0,0,244,144,231,88,2,131,79,116,42,4,0,3,2
Roger Federer,101,75,115,39,12,753,455,751,269,48,292,180,325,118,33,Novak Djokovic,115,76,101,26,9,751,482,753,298,46,325,207,292,112,14,1,8,3
Stan Wawrinka,0,0,0,0,0,492,287,447,140,23,83,49,77,19,5,Roger Federer,0,0,0,0,0,447,307,492,205,26,77,58,83,34,8,0,6,1
Rafael Nadal,0,0,0,0,0,0,0,0,0,0,88,66,105,49,1,Jarkko Nieminen,0,0,0,0,0,0,0,0,0,0,105,56,88,22,0,0,0,2
Tomas Berdych,0,0,0,0,0,80,53,100,39,6,0,0,0,0,0,Grigor Dimitrov,0,0,0,0,0,100,61,80,27,6,0,0,0,0,0,0,1,0
Roberto Bautista Agut,0,0,0,0,0,0,0,0,0,0,0,0,0,0,0,Lukasz Kubot,0,0,0,0,0,0,0,0,0,0,0,0,0,0,0,0,0,0
Santiago Giraldo,0,0,0,0,0,0,0,0,0,0,144,83,126,31,5,Andy Murray,0,0,0,0,0,0,0,0,0,0,126,95,144,61,18,0,0,2
Kei Nishikori,0,0,0,0,0,78,54,104,43,0,0,0,0,0,0,Milos Raonic,0,0,0,0,0,104,61,78,24,14,0,0,0,0,0,0,1,0
Feliciano Lopez,0,0,0,0,0,0,0,0,0,0,0,0,0,0,0,Dominic Thiem,0,0,0,0,0,0,0,0,0,0,0,0,0,0,0,0,0,0
David Ferrer,0,0,0,0,0,70,48,87,28,3,0,0,0,0,0,John Isner,0,0,0,0,0,87,59,70,22,12,0,0,0,0,0,0,1,1
Ernests Gulbis,0,0,0,0,0,0,0,0,0,0,0,0,0,0,0,Marin Cilic,0,0,0,0,0,0,0,0,0,0,0,0,0,0,0,0,0,0
Rafael Nadal,0,0,0,0,0,465,314,485,183,27,105,82,126,52,2,Tomas Berdych,0,0,0,0,0,485,302,465,151,52,126,74,105,23,7,0,6,2
Roberto Bautista Agut,0,0,0,0,0,0,0,0,0,0,0,0,0,0,0,Santiago Giraldo,0,0,0,0,0,0,0,0,0,0,0,0,0,0,0,0,0,0
Kei Nishikori,0,0,0,0,0,165,114,184,77,11,75,49,80,27,0,Feliciano Lopez,0,0,0,0,0,184,107,165,51,26,80,53,75,26,4,0,3,1
David Ferrer,0,0,0,0,0,71,47,99,46,1,0,0,0,0,0,Ernests Gulbis,0,0,0,0,0,99,53,71,24,8,0,0,0,0,0,0,1,0
Rafael Nadal,0,0,0,0,0,0,0,0,0,0,0,0,0,0,0,Roberto Bautista Agut,0,0,0,0,0,0,0,0,0,0,0,0,0,0,0,0,0,0
Kei Nishikori,75,49,83,37,2,216,108,217,78,6,0,0,0,0,0,David Ferrer,83,46,75,26,5,217,139,216,108,8,0,0,0,0,0,1,3,0
Rafael Nadal,0,0,0,0,0,128,88,135,56,5,78,55,78,36,1,Kei Nishikori,0,0,0,0,0,135,79,128,40,3,78,42,78,23,0,0,2,1
Rafael Nadal,0,0,0,0,0,67,43,58,26,1,44,31,50,25,0,Mikhail Youzhny,0,0,0,0,0,58,32,67,24,2,50,25,44,13,1,0,1,1
Andy Murray,0,0,0,0,0,70,50,72,40,13,0,0,0,0,0,Jurgen Melzer,0,0,0,0,0,72,32,70,20,1,0,0,0,0,0,0,1,0
Tommy Haas,0,0,0,0,0,0,0,0,0,0,0,0,0,0,0,Stan Wawrinka,0,0,0,0,0,0,0,0,0,0,0,0,0,0,0,0,0,0
Grigor Dimitrov,0,0,0,0,0,100,61,80,27,6,0,0,0,0,0,Tomas Berdych,0,0,0,0,0,80,53,100,39,6,0,0,0,0,0,0,1,0
Milos Raonic,167,130,191,50,23,80,60,91,25,12,0,0,0,0,0,Jo-Wilfried Tsonga,191,141,167,37,17,91,66,80,20,7,0,0,0,0,0,1,1,0
Jeremy Chardy,0,0,0,0,0,56,34,56,14,9,0,0,0,0,0,Ivan Dodig,0,0,0,0,0,56,42,56,22,11,0,0,0,0,0,0,1,0
David Ferrer,0,0,0,0,0,71,47,99,46,1,0,0,0,0,0,Ernests Gulbis,0,0,0,0,0,99,53,71,24,8,0,0,0,0,0,0,1,0
Novak Djokovic,0,0,0,0,0,0,0,0,0,0,141,94,116,40,2,Philipp Kohlschreiber,0,0,0,0,0,0,0,0,0,0,116,76,141,47,4,0,0,1
Rafael Nadal,103,76,113,42,6,188,114,185,69,6,201,118,209,103,5,Andy Murray,113,71,103,27,15,185,116,188,74,14,209,106,201,83,7,1,3,2
Grigor Dimitrov,0,0,0,0,0,136,89,144,55,19,0,0,0,0,0,Tommy Haas,0,0,0,0,0,144,89,136,47,7,0,0,0,0,0,0,2,0
Milos Raonic,0,0,0,0,0,231,179,268,91,55,0,0,0,0,0,Jeremy Chardy,0,0,0,0,0,268,177,231,52,19,0,0,0,0,0,0,3,0
Novak Djokovic,0,0,0,0,0,436,294,459,202,27,85,55,93,42,6,David Ferrer,0,0,0,0,0,459,257,436,142,12,93,51,85,30,1,0,6,1
Rafael Nadal,0,0,0,0,0,87,56,83,33,4,87,53,71,26,2,Grigor Dimitrov,0,0,0,0,0,83,50,87,31,12,71,45,87,34,8,0,1,1
Novak Djokovic,0,0,0,0,0,0,0,0,0,0,0,0,0,0,0,Milos Raonic,0,0,0,0,0,0,0,0,0,0,0,0,0,0,0,0,0,1
Novak Djokovic,95,64,82,31,7,781,508,859,351,48,600,349,607,244,14,Rafael Nadal,82,51,95,31,5,859,508,781,273,30,607,363,600,251,20,1,8,7
Rafael Nadal,0,0,0,0,0,0,0,0,0,0,0,0,0,0,0,Dusan Lajovic,0,0,0,0,0,0,0,0,0,0,0,0,0,0,0,0,0,0
David Ferrer,0,0,0,0,0,179,119,169,61,6,71,52,86,45,1,Kevin Anderson,0,0,0,0,0,169,108,179,60,13,86,41,71,19,5,0,2,1
Gael Monfils,0,0,0,0,0,0,0,0,0,0,0,0,0,0,0,Guillermo Garcia Lopez,0,0,0,0,0,0,0,0,0,0,0,0,0,0,0,0,0,0
Andy Murray,135,95,148,56,14,0,0,0,0,0,0,0,0,0,0,Fernando Verdasco,148,92,135,40,11,0,0,0,0,0,0,0,0,0,0,1,0,0
Tomas Berdych,0,0,0,0,0,161,106,159,59,13,0,0,0,0,0,John Isner,0,0,0,0,0,159,100,161,55,31,0,0,0,0,0,0,2,0
Ernests Gulbis,0,0,0,0,0,0,0,0,0,0,0,0,0,0,0,Roger Federer,0,0,0,0,0,0,0,0,0,0,0,0,0,0,0,0,0,0
Milos Raonic,0,0,0,0,0,0,0,0,0,0,0,0,0,0,0,Marcel Granollers,0,0,0,0,0,0,0,0,0,0,0,0,0,0,0,0,0,0
Novak Djokovic,177,130,205,86,9,269,196,301,134,18,227,149,208,93,12,Jo-Wilfried Tsonga,205,119,177,47,16,301,167,269,73,21,208,115,227,78,9,2,6,2
Rafael Nadal,0,0,0,0,0,211,116,204,81,6,718,440,697,348,16,David Ferrer,0,0,0,0,0,204,123,211,95,12,697,349,718,278,8,0,3,9
Andy Murray,0,0,0,0,0,0,0,0,0,0,0,0,0,0,0,Gael Monfils,0,0,0,0,0,0,0,0,0,0,0,0,0,0,0,0,0,0
Ernests Gulbis,110,85,122,37,30,99,65,98,28,19,67,34,45,11,2,Tomas Berdych,122,85,110,25,13,98,70,99,34,8,45,34,67,33,5,1,1,1
Novak Djokovic,0,0,0,0,0,0,0,0,0,0,0,0,0,0,0,Milos Raonic,0,0,0,0,0,0,0,0,0,0,0,0,0,0,0,0,0,1
Rafael Nadal,103,76,113,42,6,188,114,185,69,6,201,118,209,103,5,Andy Murray,113,71,103,27,15,185,116,188,74,14,209,106,201,83,7,1,3,2
Novak Djokovic,0,0,0,0,0,44,31,36,24,4,0,0,0,0,0,Ernests Gulbis,0,0,0,0,0,36,12,44,13,0,0,0,0,0,0,0,1,0
Rafael Nadal,82,51,95,31,5,859,508,781,273,30,607,363,600,251,20,Novak Djokovic,95,64,82,31,7,781,508,859,351,48,600,349,607,244,14,1,8,7
Novak Djokovic,177,130,205,86,9,269,196,301,134,18,227,149,208,93,12,Jo-Wilfried Tsonga,205,119,177,47,16,301,167,269,73,21,208,115,227,78,9,2,6,2
Marin Cilic,0,0,0,0,0,0,0,0,0,0,0,0,0,0,0,Jeremy Chardy,0,0,0,0,0,0,0,0,0,0,0,0,0,0,0,0,0,0
Andy Murray,0,0,0,0,0,46,23,46,11,3,0,0,0,0,0,Kevin Anderson,0,0,0,0,0,46,35,46,23,5,0,0,0,0,0,0,1,0
Grigor Dimitrov,0,0,0,0,0,0,0,0,0,0,0,0,0,0,0,Leonardo Mayer,0,0,0,0,0,0,0,0,0,0,0,0,0,0,0,0,0,0
Stan Wawrinka,0,0,0,0,0,71,55,84,33,19,150,98,156,64,29,Feliciano Lopez,0,0,0,0,0,84,51,71,16,5,156,92,150,52,9,0,1,2
Roger Federer,0,0,0,0,0,191,131,234,87,16,0,0,0,0,0,Tommy Robredo,0,0,0,0,0,234,147,191,60,13,0,0,0,0,0,0,2,0
Milos Raonic,0,0,0,0,0,104,61,78,24,14,0,0,0,0,0,Kei Nishikori,0,0,0,0,0,78,54,104,43,0,0,0,0,0,0,0,1,0
Nick Kyrgios,0,0,0,0,0,0,0,0,0,0,0,0,0,0,0,Rafael Nadal,0,0,0,0,0,0,0,0,0,0,0,0,0,0,0,0,0,0
Novak Djokovic,0,0,0,0,0,120,86,111,48,8,0,0,0,0,0,Marin Cilic,0,0,0,0,0,111,63,120,34,8,0,0,0,0,0,0,2,0
Grigor Dimitrov,0,0,0,0,0,195,119,219,73,10,0,0,0,0,0,Andy Murray,0,0,0,0,0,219,146,195,76,18,0,0,0,0,0,0,3,0
Roger Federer,0,0,0,0,0,447,307,492,205,26,77,58,83,34,8,Stan Wawrinka,0,0,0,0,0,492,287,447,140,23,83,49,77,19,5,0,6,1
Milos Raonic,0,0,0,0,0,0,0,0,0,0,0,0,0,0,0,Nick Kyrgios,0,0,0,0,0,0,0,0,0,0,0,0,0,0,0,0,0,0
Novak Djokovic,0,0,0,0,0,96,76,102,44,6,196,131,215,90,7,Grigor Dimitrov,0,0,0,0,0,102,58,96,20,6,215,125,196,65,13,0,2,2
Roger Federer,94,77,99,23,9,166,134,192,66,24,111,77,91,22,7,Milos Raonic,99,76,94,17,25,192,126,166,32,29,91,69,111,34,21,1,2,1
Novak Djokovic,115,76,101,26,9,751,482,753,298,46,325,207,292,112,14,Roger Federer,101,75,115,39,12,753,455,751,269,48,292,180,325,118,33,1,8,3
Jo-Wilfried Tsonga,205,119,177,47,16,301,167,269,73,21,208,115,227,78,9,Novak Djokovic,177,130,205,86,9,269,196,301,134,18,227,149,208,93,12,2,6,2
Andy Murray,93,67,84,30,14,83,55,75,37,6,197,124,230,98,12,Richard Gasquet,84,54,93,26,2,75,38,83,28,2,230,132,197,73,8,1,1,2
Kevin Anderson,0,0,0,0,0,216,140,164,44,27,0,0,0,0,0,Stan Wawrinka,0,0,0,0,0,164,120,216,76,17,0,0,0,0,0,0,2,0
Grigor Dimitrov,0,0,0,0,0,0,0,0,0,0,62,32,51,16,1,Tommy Robredo,0,0,0,0,0,0,0,0,0,0,51,35,62,30,1,0,0,1
Milos Raonic,0,0,0,0,0,103,78,113,32,22,58,41,50,22,15,Julien Benneteau,0,0,0,0,0,113,81,103,25,11,50,28,58,17,2,0,2,1
Feliciano Lopez,0,0,0,0,0,131,90,118,32,22,0,0,0,0,0,Tomas Berdych,0,0,0,0,0,118,86,131,41,15,0,0,0,0,0,0,2,0
David Ferrer,125,91,148,59,7,85,64,116,50,3,0,0,0,0,0,Ivan Dodig,148,89,125,34,14,116,66,85,21,6,0,0,0,0,0,1,1,0
Roger Federer,0,0,0,0,0,170,113,185,82,14,54,42,52,18,0,Marin Cilic,0,0,0,0,0,185,103,170,57,13,52,34,54,12,3,0,2,1
Jo-Wilfried Tsonga,333,206,278,81,31,72,41,67,22,1,0,0,0,0,0,Andy Murray,278,197,333,127,25,67,45,72,31,3,0,0,0,0,0,3,1,0
Grigor Dimitrov,313,217,309,110,39,99,76,110,32,7,0,0,0,0,0,Kevin Anderson,309,199,313,96,43,110,78,99,23,15,0,0,0,0,0,3,1,0
Feliciano Lopez,0,0,0,0,0,192,121,157,36,13,97,70,91,25,12,Milos Raonic,0,0,0,0,0,157,121,192,71,48,91,66,97,27,23,0,2,1
Roger Federer,0,0,0,0,0,142,101,140,52,10,46,40,83,34,7,David Ferrer,0,0,0,0,0,140,88,142,41,1,83,49,46,6,3,0,2,1
Jo-Wilfried Tsonga,166,107,170,67,19,136,101,128,39,20,0,0,0,0,0,Grigor Dimitrov,170,103,166,59,3,128,89,136,35,11,0,0,0,0,0,1,2,0
Roger Federer,0,0,0,0,0,53,44,66,23,12,225,171,229,70,37,Feliciano Lopez,0,0,0,0,0,66,43,53,9,8,229,159,225,54,30,0,1,2
Jo-Wilfried Tsonga,145,103,137,33,18,639,414,638,190,59,129,87,166,68,5,Roger Federer,137,104,145,42,17,638,448,639,225,42,166,98,129,42,2,1,8,2
Tommy Robredo,0,0,0,0,0,0,0,0,0,0,0,0,0,0,0,Novak Djokovic,0,0,0,0,0,0,0,0,0,0,0,0,0,0,0,0,0,0
David Ferrer,0,0,0,0,0,59,34,62,22,1,74,52,69,39,2,Mikhail Youzhny,0,0,0,0,0,62,40,59,25,5,69,30,74,22,0,0,1,1
Stan Wawrinka,0,0,0,0,0,58,43,68,28,3,0,0,0,0,0,Marin Cilic,0,0,0,0,0,68,40,58,15,2,0,0,0,0,0,0,1,0
Julien Benneteau,0,0,0,0,0,165,101,158,52,17,0,0,0,0,0,Jerzy Janowicz,0,0,0,0,0,158,106,165,64,29,0,0,0,0,0,0,2,0
Milos Raonic,0,0,0,0,0,0,0,0,0,0,0,0,0,0,0,Steve Johnson,0,0,0,0,0,0,0,0,0,0,0,0,0,0,0,0,0,0
Fabio Fognini,0,0,0,0,0,141,86,110,37,5,0,0,0,0,0,Yen Hsun Lu,0,0,0,0,0,110,73,141,55,4,0,0,0,0,0,0,1,0
Andy Murray,0,0,0,0,0,128,94,135,46,14,0,0,0,0,0,John Isner,0,0,0,0,0,135,89,128,34,17,0,0,0,0,0,0,1,0
Roger Federer,0,0,0,0,0,102,67,104,31,3,88,61,133,60,4,Gael Monfils,0,0,0,0,0,104,73,102,35,15,133,73,88,27,4,0,1,1
David Ferrer,0,0,0,0,0,0,0,0,0,0,195,138,207,100,5,Tommy Robredo,0,0,0,0,0,0,0,0,0,0,207,107,195,57,7,0,0,3
Julien Benneteau,0,0,0,0,0,59,36,59,29,3,0,0,0,0,0,Stan Wawrinka,0,0,0,0,0,59,30,59,23,0,0,0,0,0,0,0,1,0
Milos Raonic,0,0,0,0,0,0,0,0,0,0,0,0,0,0,0,Fabio Fognini,0,0,0,0,0,0,0,0,0,0,0,0,0,0,0,0,1,0
Roger Federer,209,131,244,88,21,374,237,346,117,15,0,0,0,0,0,Andy Murray,244,156,209,78,21,346,229,374,137,38,0,0,0,0,0,2,4,0
David Ferrer,0,0,0,0,0,168,103,201,89,8,73,59,102,44,3,Julien Benneteau,0,0,0,0,0,201,112,168,65,8,102,58,73,14,4,0,3,1
Roger Federer,94,77,99,23,9,166,134,192,66,24,111,77,91,22,7,Milos Raonic,99,76,94,17,25,192,126,166,32,29,91,69,111,34,21,1,2,1
Roger Federer,0,0,0,0,0,142,101,140,52,10,46,40,83,34,7,David Ferrer,0,0,0,0,0,140,88,142,41,1,83,49,46,6,3,0,2,1
Novak Djokovic,0,0,0,0,0,0,0,0,0,0,141,94,116,40,2,Philipp Kohlschreiber,0,0,0,0,0,0,0,0,0,0,116,76,141,47,4,0,0,1
Andy Murray,278,197,333,127,25,67,45,72,31,3,0,0,0,0,0,Jo-Wilfried Tsonga,333,206,278,81,31,72,41,67,22,1,0,0,0,0,0,3,1,0
Stan Wawrinka,0,0,0,0,0,99,58,102,38,11,70,39,84,36,1,Tommy Robredo,0,0,0,0,0,102,64,99,41,7,84,48,70,31,3,0,1,1
Kei Nishikori,0,0,0,0,0,78,54,104,43,0,0,0,0,0,0,Milos Raonic,0,0,0,0,0,104,61,78,24,14,0,0,0,0,0,0,1,0
Tomas Berdych,0,0,0,0,0,0,0,0,0,0,0,0,0,0,0,Dominic Thiem,0,0,0,0,0,0,0,0,0,0,0,0,0,0,0,0,0,0
Marin Cilic,0,0,0,0,0,0,0,0,0,0,0,0,0,0,0,Gilles Simon,0,0,0,0,0,0,0,0,0,0,0,0,0,0,0,0,0,0
Gael Monfils,0,0,0,0,0,111,70,117,52,2,0,0,0,0,0,Grigor Dimitrov,0,0,0,0,0,117,65,111,41,3,0,0,0,0,0,0,1,0
Roger Federer,0,0,0,0,0,0,0,0,0,0,0,0,0,0,0,Roberto Bautista Agut,0,0,0,0,0,0,0,0,0,0,0,0,0,0,0,0,0,0
Novak Djokovic,170,98,192,69,7,914,566,955,398,45,96,58,98,45,4,Andy Murray,192,123,170,72,15,955,557,914,348,52,98,53,96,38,6,2,9,1
Kei Nishikori,0,0,0,0,0,52,30,50,13,0,62,36,61,18,1,Stan Wawrinka,0,0,0,0,0,50,37,52,22,9,61,43,62,26,4,0,1,1
Marin Cilic,86,61,71,21,8,120,82,143,51,11,67,35,59,17,6,Tomas Berdych,71,50,86,25,5,143,92,120,38,15,59,42,67,32,5,1,2,1
Roger Federer,0,0,0,0,0,102,67,104,31,3,88,61,133,60,4,Gael Monfils,0,0,0,0,0,104,73,102,35,15,133,73,88,27,4,0,1,1
Kei Nishikori,0,0,0,0,0,82,50,91,40,4,0,0,0,0,0,Novak Djokovic,0,0,0,0,0,91,51,82,32,6,0,0,0,0,0,0,1,0
Marin Cilic,0,0,0,0,0,185,103,170,57,13,52,34,54,12,3,Roger Federer,0,0,0,0,0,170,113,185,82,14,54,42,52,18,0,0,2,1
Marin Cilic,0,0,0,0,0,276,182,283,96,30,0,0,0,0,0,Kei Nishikori,0,0,0,0,0,283,187,276,94,9,0,0,0,0,0,0,3,0
Novak Djokovic,0,0,0,0,0,0,0,0,0,0,0,0,0,0,0,Mikhail Kukushkin,0,0,0,0,0,0,0,0,0,0,0,0,0,0,0,0,0,0
David Ferrer,165,107,150,42,6,448,243,449,186,17,141,81,158,79,3,Andy Murray,150,108,165,58,18,449,263,448,205,26,158,79,141,60,3,1,5,1
Roger Federer,0,0,0,0,0,0,0,0,0,0,0,0,0,0,0,Roberto Bautista Agut,0,0,0,0,0,0,0,0,0,0,0,0,0,0,0,0,0,0
Julien Benneteau,0,0,0,0,0,0,0,0,0,0,0,0,0,0,0,Jack Sock,0,0,0,0,0,0,0,0,0,0,0,0,0,0,0,0,0,0
Tomas Berdych,0,0,0,0,0,172,127,182,60,21,0,0,0,0,0,Ivo Karlovic,0,0,0,0,0,182,122,172,45,35,0,0,0,0,0,0,2,0
Gilles Simon,0,0,0,0,0,0,0,0,0,0,0,0,0,0,0,Malek Jaziri,0,0,0,0,0,0,0,0,0,0,0,0,0,0,0,0,0,0
Mikhail Youzhny,135,89,136,54,4,0,0,0,0,0,119,68,102,41,4,Juan Monaco,136,82,135,46,6,0,0,0,0,0,102,61,119,51,7,1,0,1
Feliciano Lopez,0,0,0,0,0,206,139,207,70,19,105,75,129,40,9,John Isner,0,0,0,0,0,207,137,206,67,40,129,89,105,30,13,0,2,1
Novak Djokovic,0,0,0,0,0,436,294,459,202,27,85,55,93,42,6,David Ferrer,0,0,0,0,0,459,257,436,142,12,93,51,85,30,1,0,6,1
Roger Federer,203,145,222,88,21,69,36,57,21,7,79,64,83,34,7,Julien Benneteau,222,134,203,58,18,57,36,69,33,6,83,49,79,15,2,2,1,1
Gilles Simon,0,0,0,0,0,204,118,182,72,8,0,0,0,0,0,Tomas Berdych,0,0,0,0,0,182,110,204,86,23,0,0,0,0,0,0,2,0
Feliciano Lopez,0,0,0,0,0,100,61,105,40,20,0,0,0,0,0,Mikhail Youzhny,0,0,0,0,0,105,65,100,39,4,0,0,0,0,0,0,1,0
Roger Federer,101,75,115,39,12,753,455,751,269,48,292,180,325,118,33,Novak Djokovic,115,76,101,26,9,751,482,753,298,46,325,207,292,112,14,1,8,3
Gilles Simon,243,149,201,50,9,0,0,0,0,0,0,0,0,0,0,Feliciano Lopez,201,151,243,94,37,0,0,0,0,0,0,0,0,0,0,2,0,0
Roger Federer,0,0,0,0,0,131,86,164,77,11,161,113,216,98,12,Gilles Simon,0,0,0,0,0,164,87,131,45,8,216,118,161,48,6,0,2,2
Novak Djokovic,0,0,0,0,0,235,156,247,108,7,0,0,0,0,0,Gael Monfils,0,0,0,0,0,247,139,235,79,24,0,0,0,0,0,0,3,0
Andy Murray,0,0,0,0,0,219,146,195,76,18,0,0,0,0,0,Grigor Dimitrov,0,0,0,0,0,195,119,219,73,10,0,0,0,0,0,0,3,0
David Ferrer,0,0,0,0,0,116,83,131,58,3,221,147,220,96,11,Fernando Verdasco,0,0,0,0,0,131,73,116,33,5,220,124,221,74,6,0,3,3
Kei Nishikori,0,0,0,0,0,389,245,402,146,10,0,0,0,0,0,Jo-Wilfried Tsonga,0,0,0,0,0,402,256,389,144,52,0,0,0,0,0,0,4,0
Tomas Berdych,0,0,0,0,0,118,86,131,41,15,0,0,0,0,0,Feliciano Lopez,0,0,0,0,0,131,90,118,32,22,0,0,0,0,0,0,2,0
Kevin Anderson,0,0,0,0,0,216,140,164,44,27,0,0,0,0,0,Stan Wawrinka,0,0,0,0,0,164,120,216,76,17,0,0,0,0,0,0,2,0
Milos Raonic,0,0,0,0,0,0,0,0,0,0,0,0,0,0,0,Roberto Bautista Agut,0,0,0,0,0,0,0,0,0,0,0,0,0,0,0,0,0,0
Roger Federer,0,0,0,0,0,0,0,0,0,0,0,0,0,0,0,Lucas Pouille,0,0,0,0,0,0,0,0,0,0,0,0,0,0,0,0,0,0
Novak Djokovic,170,98,192,69,7,914,566,955,398,45,96,58,98,45,4,Andy Murray,192,123,170,72,15,955,557,914,348,52,98,53,96,38,6,2,9,1
Kei Nishikori,75,49,83,37,2,216,108,217,78,6,0,0,0,0,0,David Ferrer,83,46,75,26,5,217,139,216,108,8,0,0,0,0,0,1,3,0
Tomas Berdych,124,81,121,43,11,368,253,376,146,32,347,238,328,115,36,Kevin Anderson,121,78,124,43,19,376,230,368,115,52,328,213,347,109,46,1,4,4
Milos Raonic,99,76,94,17,25,192,126,166,32,29,91,69,111,34,21,Roger Federer,94,77,99,23,9,166,134,192,66,24,111,77,91,22,7,1,2,1
Novak Djokovic,0,0,0,0,0,91,51,82,32,6,0,0,0,0,0,Kei Nishikori,0,0,0,0,0,82,50,91,40,4,0,0,0,0,0,0,1,0
Milos Raonic,0,0,0,0,0,215,155,212,63,56,0,0,0,0,0,Tomas Berdych,0,0,0,0,0,212,149,215,60,17,0,0,0,0,0,0,3,0
Novak Djokovic,0,0,0,0,0,0,0,0,0,0,0,0,0,0,0,Milos Raonic,0,0,0,0,0,0,0,0,0,0,0,0,0,0,0,0,0,1
Novak Djokovic,0,0,0,0,0,513,339,575,240,24,122,89,138,58,9,Stan Wawrinka,0,0,0,0,0,575,335,513,174,36,138,80,122,33,11,0,5,2
Novak Djokovic,89,63,99,39,16,577,404,625,265,58,187,119,195,76,14,Tomas Berdych,99,60,89,26,6,625,360,577,173,45,195,119,187,68,12,1,9,2
Novak Djokovic,0,0,0,0,0,120,86,111,48,8,0,0,0,0,0,Marin Cilic,0,0,0,0,0,111,63,120,34,8,0,0,0,0,0,0,2,0
Stan Wawrinka,0,0,0,0,0,365,245,360,144,41,88,56,79,25,5,Tomas Berdych,0,0,0,0,0,360,216,365,120,23,79,54,88,32,8,0,5,1
Stan Wawrinka,0,0,0,0,0,58,43,68,28,3,0,0,0,0,0,Marin Cilic,0,0,0,0,0,68,40,58,15,2,0,0,0,0,0,0,1,0
Tomas Berdych,71,50,86,25,5,143,92,120,38,15,59,42,67,32,5,Marin Cilic,86,61,71,21,8,120,82,143,51,11,67,35,59,17,6,1,2,1
Roger Federer,0,0,0,0,0,39,33,65,31,5,65,46,80,30,7,Kei Nishikori,0,0,0,0,0,65,34,39,6,0,80,50,65,19,1,0,1,1
Roger Federer,209,131,244,88,21,374,237,346,117,15,0,0,0,0,0,Andy Murray,244,156,209,78,21,346,229,374,137,38,0,0,0,0,0,2,4,0
Kei Nishikori,0,0,0,0,0,175,82,146,41,2,0,0,0,0,0,Andy Murray,0,0,0,0,0,146,105,175,93,15,0,0,0,0,0,0,3,0
Kei Nishikori,75,49,83,37,2,216,108,217,78,6,0,0,0,0,0,David Ferrer,83,46,75,26,5,217,139,216,108,8,0,0,0,0,0,1,3,0
Roger Federer,94,77,99,23,9,166,134,192,66,24,111,77,91,22,7,Milos Raonic,99,76,94,17,25,192,126,166,32,29,91,69,111,34,21,1,2,1
Andy Murray,0,0,0,0,0,186,132,198,70,17,71,46,69,18,3,Milos Raonic,0,0,0,0,0,198,128,186,54,27,69,51,71,25,14,0,4,1
Roger Federer,0,0,0,0,0,447,307,492,205,26,77,58,83,34,8,Stan Wawrinka,0,0,0,0,0,492,287,447,140,23,83,49,77,19,5,0,6,1
Novak Djokovic,0,0,0,0,0,91,51,82,32,6,0,0,0,0,0,Kei Nishikori,0,0,0,0,0,82,50,91,40,4,0,0,0,0,0,0,1,0
Novak Djokovic,115,76,101,26,9,751,482,753,298,46,325,207,292,112,14,Roger Federer,101,75,115,39,12,753,455,751,269,48,292,180,325,118,33,1,8,3
