name1,grass_pts_served1,grass_service_pts_won1,grass_pts_received1,grass_receiving_pts_won1,grass_aces1,hard_pts_served1,hard_service_pts_won1,hard_pts_received1,hard_receiving_pts_won1,hard_aces1,clay_pts_served1,clay_service_pts_won1,clay_pts_received1,clay_receiving_pts_won1,clay_aces1,name2,grass_pts_served2,grass_service_pts_won2,grass_pts_received2,grass_receiving_pts_won2,grass_aces2,hard_pts_served2,hard_service_pts_won2,hard_pts_received2,hard_receiving_pts_won2,hard_aces2,clay_pts_served2,clay_service_pts_won2,clay_pts_received2,clay_receiving_pts_won2,clay_aces2,grass_sample_size,hard_sample_size,clay_sample_size
Ashleigh Barty,0,0,0,0,0,0,0,0,0,0,93,54,97,49,5,Amanda Anisimova,0,0,0,0,0,0,0,0,0,0,97,48,93,39,0,0,0,1
Jessica Pegula,57,26,38,9,1,99,56,129,60,5,0,0,0,0,0,Maria Sakkari,38,29,57,31,6,129,69,99,43,4,0,0,0,0,0,1,1,0
Barbora Krejcikova,0,0,0,0,0,68,39,104,42,2,0,0,0,0,0,Victoria Azarenka,0,0,0,0,0,104,62,68,29,6,0,0,0,0,0,0,1,0
Madison Keys,0,0,0,0,0,0,0,0,0,0,0,0,0,0,0,Paula Badosa,0,0,0,0,0,0,0,0,0,0,0,0,0,0,0,0,0,0
Danielle Collins,0,0,0,0,0,56,29,52,32,0,0,0,0,0,0,Elise Mertens,0,0,0,0,0,52,20,56,27,3,0,0,0,0,0,0,1,0
Alize Cornet,0,0,0,0,0,0,0,0,0,0,0,0,0,0,0,Simona Halep,0,0,0,0,0,0,0,0,0,0,0,0,0,0,0,0,0,0
Iga Swiatek,0,0,0,0,0,0,0,0,0,0,0,0,0,0,0,Sorana Cirstea,0,0,0,0,0,0,0,0,0,0,0,0,0,0,0,0,0,0
Kaia Kanepi,0,0,0,0,0,95,52,62,31,5,0,0,0,0,0,Aryna Sabalenka,0,0,0,0,0,62,31,95,43,2,0,0,0,0,0,0,1,0
Ashleigh Barty,0,0,0,0,0,0,0,0,0,0,55,30,47,28,3,Jessica Pegula,0,0,0,0,0,0,0,0,0,0,47,19,55,25,1,0,0,1
Madison Keys,0,0,0,0,0,0,0,0,0,0,0,0,0,0,0,Barbora Krejcikova,0,0,0,0,0,0,0,0,0,0,0,0,0,0,0,0,0,0
Danielle Collins,0,0,0,0,0,0,0,0,0,0,0,0,0,0,0,Alize Cornet,0,0,0,0,0,0,0,0,0,0,0,0,0,0,0,0,0,0
Iga Swiatek,0,0,0,0,0,0,0,0,0,0,0,0,0,0,0,Kaia Kanepi,0,0,0,0,0,0,0,0,0,0,0,0,0,0,0,0,0,0
Ashleigh Barty,0,0,0,0,0,61,33,51,34,3,60,44,60,24,4,Madison Keys,0,0,0,0,0,51,17,61,28,1,60,36,60,16,8,0,1,1
Danielle Collins,0,0,0,0,0,39,14,38,14,2,0,0,0,0,0,Iga Swiatek,0,0,0,0,0,38,24,39,25,0,0,0,0,0,0,0,1,0
Ashleigh Barty,0,0,0,0,0,126,82,135,49,18,131,84,117,53,9,Danielle Collins,0,0,0,0,0,135,86,126,44,7,117,64,131,47,4,0,2,2
Iga Swiatek,0,0,0,0,0,60,34,48,11,2,61,35,62,19,0,Maria Sakkari,0,0,0,0,0,48,37,60,26,2,62,43,61,26,5,0,2,1
Anett Kontaveit,61,33,50,17,5,0,0,0,0,0,0,0,0,0,0,Jelena Ostapenko,50,33,61,28,1,0,0,0,0,0,0,0,0,0,0,1,0,0
Iga Swiatek,0,0,0,0,0,85,52,92,37,2,0,0,0,0,0,Aryna Sabalenka,0,0,0,0,0,92,55,85,33,8,0,0,0,0,0,0,1,0
Maria Sakkari,0,0,0,0,0,118,67,111,48,5,68,35,87,37,4,Cori Gauff,0,0,0,0,0,111,63,118,51,7,87,50,68,33,3,0,2,1
Anett Kontaveit,0,0,0,0,0,205,105,159,64,1,0,0,0,0,0,Ons Jabeur,0,0,0,0,0,159,95,205,100,8,0,0,0,0,0,0,2,0
Jelena Ostapenko,0,0,0,0,0,0,0,0,0,0,0,0,0,0,0,Garbine Muguruza,0,0,0,0,0,0,0,0,0,0,0,0,0,0,0,0,0,0
Aryna Sabalenka,0,0,0,0,0,0,0,0,0,0,0,0,0,0,0,Jil Teichmann,0,0,0,0,0,0,0,0,0,0,0,0,0,0,0,0,0,0
Iga Swiatek,69,29,72,28,2,0,0,0,0,0,0,0,0,0,0,Daria Kasatkina,72,44,69,40,4,0,0,0,0,0,0,0,0,0,0,1,0,0
Cori Gauff,0,0,0,0,0,42,21,42,9,2,0,0,0,0,0,Paula Badosa,0,0,0,0,0,42,33,42,21,1,0,0,0,0,0,0,1,0
Maria Sakkari,38,29,57,31,6,129,69,99,43,4,0,0,0,0,0,Jessica Pegula,57,26,38,9,1,99,56,129,60,5,0,0,0,0,0,1,1,0
Ons Jabeur,0,0,0,0,0,0,0,0,0,0,0,0,0,0,0,Tereza Martincova,0,0,0,0,0,0,0,0,0,0,0,0,0,0,0,0,0,0
Anett Kontaveit,0,0,0,0,0,109,49,126,52,2,0,0,0,0,0,Elise Mertens,0,0,0,0,0,126,74,109,60,9,0,0,0,0,0,0,2,0
Garbine Muguruza,0,0,0,0,0,0,0,0,0,0,0,0,0,0,0,Madison Brengle,0,0,0,0,0,0,0,0,0,0,0,0,0,0,0,0,0,0
Jelena Ostapenko,0,0,0,0,0,50,23,60,23,1,0,0,0,0,0,Barbora Krejcikova,0,0,0,0,0,60,37,50,27,5,0,0,0,0,0,0,1,0
Iga Swiatek,0,0,0,0,0,268,145,316,145,13,63,43,58,26,2,Anett Kontaveit,0,0,0,0,0,316,171,268,123,15,58,32,63,20,4,0,3,1
Iga Swiatek,0,0,0,0,0,60,34,48,11,2,61,35,62,19,0,Maria Sakkari,0,0,0,0,0,48,37,60,26,2,62,43,61,26,5,0,2,1
Iga Swiatek,0,0,0,0,0,90,52,69,22,2,82,43,100,44,1,Simona Halep,0,0,0,0,0,69,47,90,38,3,100,56,82,39,2,0,1,2
Maria Sakkari,0,0,0,0,0,90,49,81,30,1,0,0,0,0,0,Paula Badosa,0,0,0,0,0,81,51,90,41,10,0,0,0,0,0,0,1,0
Simona Halep,0,0,0,0,0,0,0,0,0,0,0,0,0,0,0,Petra Martic,0,0,0,0,0,0,0,0,0,0,0,0,0,0,0,0,0,0
Iga Swiatek,0,0,0,0,0,0,0,0,0,0,56,37,68,34,1,Madison Keys,0,0,0,0,0,0,0,0,0,0,68,34,56,19,6,0,0,1
Paula Badosa,0,0,0,0,0,79,41,76,31,5,49,26,82,34,3,Veronika Kudermetova,0,0,0,0,0,76,45,79,38,10,82,48,49,23,5,0,1,1
Maria Sakkari,0,0,0,0,0,91,46,76,31,3,0,0,0,0,0,Elena Rybakina,0,0,0,0,0,76,45,91,45,5,0,0,0,0,0,0,1,0
Simona Halep,0,0,0,0,0,0,0,0,0,0,0,0,0,0,0,Sorana Cirstea,0,0,0,0,0,0,0,0,0,0,0,0,0,0,0,0,0,0
Petra Martic,0,0,0,0,0,78,53,99,45,5,171,113,164,64,13,Liudmila Samsonova,0,0,0,0,0,99,54,78,25,7,164,100,171,58,9,0,1,2
Iga Swiatek,0,0,0,0,0,0,0,0,0,0,0,0,0,0,0,Angelique Kerber,0,0,0,0,0,0,0,0,0,0,0,0,0,0,0,0,0,0
Madison Keys,0,0,0,0,0,0,0,0,0,0,0,0,0,0,0,Harriet Dart,0,0,0,0,0,0,0,0,0,0,0,0,0,0,0,0,0,0
Paula Badosa,0,0,0,0,0,0,0,0,0,0,0,0,0,0,0,Leylah Fernandez,0,0,0,0,0,0,0,0,0,0,0,0,0,0,0,0,0,0
Veronika Kudermetova,0,0,0,0,0,0,0,0,0,0,0,0,0,0,0,Marketa Vondrousova,0,0,0,0,0,0,0,0,0,0,0,0,0,0,0,0,0,0
Maria Sakkari,0,0,0,0,0,0,0,0,0,0,0,0,0,0,0,Daria Saville,0,0,0,0,0,0,0,0,0,0,0,0,0,0,0,0,0,0
Elena Rybakina,0,0,0,0,0,91,41,109,60,2,0,0,0,0,0,Viktorija Golubic,0,0,0,0,0,109,49,91,50,1,0,0,0,0,0,0,1,0
Iga Swiatek,0,0,0,0,0,76,42,75,26,4,0,0,0,0,0,Naomi Osaka,0,0,0,0,0,75,49,76,34,9,0,0,0,0,0,0,1,0
Naomi Osaka,0,0,0,0,0,120,64,102,29,10,92,50,92,37,12,Belinda Bencic,0,0,0,0,0,102,73,120,56,4,92,55,92,42,1,0,2,1
Iga Swiatek,0,0,0,0,0,90,49,117,51,2,0,0,0,0,0,Jessica Pegula,0,0,0,0,0,117,66,90,41,6,0,0,0,0,0,0,1,0
Belinda Bencic,0,0,0,0,0,0,0,0,0,0,0,0,0,0,0,Daria Saville,0,0,0,0,0,0,0,0,0,0,0,0,0,0,0,0,0,0
Naomi Osaka,0,0,0,0,0,50,35,76,37,3,0,0,0,0,0,Danielle Collins,0,0,0,0,0,76,39,50,15,1,0,0,0,0,0,0,1,0
Jessica Pegula,0,0,0,0,0,0,0,0,0,0,0,0,0,0,0,Paula Badosa,0,0,0,0,0,0,0,0,0,0,0,0,0,0,0,0,0,0
Iga Swiatek,0,0,0,0,0,0,0,0,0,0,0,0,0,0,0,Petra Kvitova,0,0,0,0,0,0,0,0,0,0,0,0,0,0,0,0,0,0
Belinda Bencic,0,0,0,0,0,0,0,0,0,0,0,0,0,0,0,Aliaksandra Sasnovich,0,0,0,0,0,0,0,0,0,0,0,0,0,0,0,0,0,0
Daria Saville,0,0,0,0,0,0,0,0,0,0,0,0,0,0,0,Lucia Bronzetti,0,0,0,0,0,0,0,0,0,0,0,0,0,0,0,0,0,0
Naomi Osaka,0,0,0,0,0,57,35,45,25,7,0,0,0,0,0,Alison Riske Amritraj,0,0,0,0,0,45,20,57,22,0,0,0,0,0,0,0,1,0
Danielle Collins,0,0,0,0,0,75,35,44,14,0,91,52,91,41,1,Ons Jabeur,0,0,0,0,0,44,30,75,40,2,91,50,91,39,5,0,1,1
Paula Badosa,0,0,0,0,0,0,0,0,0,0,0,0,0,0,0,Linda Fruhvirtova,0,0,0,0,0,0,0,0,0,0,0,0,0,0,0,0,0,0
Jessica Pegula,0,0,0,0,0,0,0,0,0,0,0,0,0,0,0,Anhelina Kalinina,0,0,0,0,0,0,0,0,0,0,0,0,0,0,0,0,0,0
Petra Kvitova,0,0,0,0,0,52,35,60,30,10,80,59,95,35,7,Veronika Kudermetova,0,0,0,0,0,60,30,52,17,6,95,60,80,21,4,0,1,1
Iga Swiatek,0,0,0,0,0,0,0,0,0,0,74,49,72,30,1,Cori Gauff,0,0,0,0,0,0,0,0,0,0,72,42,74,25,7,0,0,1
Ons Jabeur,0,0,0,0,0,77,43,73,31,4,0,0,0,0,0,Jessica Pegula,0,0,0,0,0,73,42,77,34,1,0,0,0,0,0,0,2,0
Jessica Pegula,0,0,0,0,0,0,0,0,0,0,0,0,0,0,0,Jil Teichmann,0,0,0,0,0,0,0,0,0,0,0,0,0,0,0,0,0,0
Ons Jabeur,0,0,0,0,0,27,10,28,8,0,0,0,0,0,0,Ekaterina Alexandrova,0,0,0,0,0,28,20,27,17,5,0,0,0,0,0,0,1,0
Jil Teichmann,0,0,0,0,0,0,0,0,0,0,0,0,0,0,0,Anhelina Kalinina,0,0,0,0,0,0,0,0,0,0,0,0,0,0,0,0,0,0
Jessica Pegula,0,0,0,0,0,0,0,0,0,0,0,0,0,0,0,Sara Sorribes Tormo,0,0,0,0,0,0,0,0,0,0,0,0,0,0,0,0,0,0
Ekaterina Alexandrova,0,0,0,0,0,80,47,81,27,6,0,0,0,0,0,Amanda Anisimova,0,0,0,0,0,81,54,80,33,2,0,0,0,0,0,0,1,0
Ons Jabeur,0,0,0,0,0,97,53,90,39,1,0,0,0,0,0,Simona Halep,0,0,0,0,0,90,51,97,44,1,0,0,0,0,0,0,1,0
Jil Teichmann,0,0,0,0,0,0,0,0,0,0,0,0,0,0,0,Elena Rybakina,0,0,0,0,0,0,0,0,0,0,0,0,0,0,0,0,0,0
Anhelina Kalinina,0,0,0,0,0,0,0,0,0,0,0,0,0,0,0,Emma Raducanu,0,0,0,0,0,0,0,0,0,0,0,0,0,0,0,0,0,0
Sara Sorribes Tormo,0,0,0,0,0,0,0,0,0,0,0,0,0,0,0,Daria Kasatkina,0,0,0,0,0,0,0,0,0,0,0,0,0,0,0,0,0,0
Jessica Pegula,0,0,0,0,0,0,0,0,0,0,0,0,0,0,0,Bianca Andreescu,0,0,0,0,0,0,0,0,0,0,0,0,0,0,0,0,0,0
Ekaterina Alexandrova,0,0,0,0,0,0,0,0,0,0,0,0,0,0,0,Marie Bouzkova,0,0,0,0,0,0,0,0,0,0,0,0,0,0,0,0,0,0
Amanda Anisimova,0,0,0,0,0,0,0,0,0,0,0,0,0,0,0,Victoria Azarenka,0,0,0,0,0,0,0,0,0,0,0,0,0,0,0,0,0,0
Ons Jabeur,0,0,0,0,0,0,0,0,0,0,65,43,74,22,7,Belinda Bencic,0,0,0,0,0,0,0,0,0,0,74,52,65,22,4,0,0,1
Simona Halep,58,36,61,32,2,0,0,0,0,0,0,0,0,0,0,Cori Gauff,61,29,58,22,0,0,0,0,0,0,0,0,0,0,0,1,0,0
Iga Swiatek,68,32,89,33,2,135,78,177,75,3,0,0,0,0,0,Ons Jabeur,89,56,68,36,9,177,102,135,57,20,0,0,0,0,0,1,2,0
Iga Swiatek,0,0,0,0,0,85,52,92,37,2,0,0,0,0,0,Aryna Sabalenka,0,0,0,0,0,92,55,85,33,8,0,0,0,0,0,0,1,0
Ons Jabeur,67,40,67,33,1,114,65,90,42,5,0,0,0,0,0,Daria Kasatkina,67,34,67,27,1,90,48,114,49,0,0,0,0,0,0,1,1,0
Iga Swiatek,0,0,0,0,0,0,0,0,0,0,0,0,0,0,0,Bianca Andreescu,0,0,0,0,0,0,0,0,0,0,0,0,0,0,0,0,0,0
Aryna Sabalenka,0,0,0,0,0,57,30,52,15,3,62,25,56,28,0,Amanda Anisimova,0,0,0,0,0,52,37,57,27,4,56,28,62,37,1,0,1,1
Ons Jabeur,0,0,0,0,0,97,53,66,20,6,0,0,0,0,0,Maria Sakkari,0,0,0,0,0,66,46,97,44,7,0,0,0,0,0,0,1,0
Daria Kasatkina,0,0,0,0,0,51,33,58,31,0,0,0,0,0,0,Jil Teichmann,0,0,0,0,0,58,27,51,18,1,0,0,0,0,0,0,1,0
Iga Swiatek,0,0,0,0,0,79,33,61,30,0,0,0,0,0,0,Victoria Azarenka,0,0,0,0,0,61,31,79,46,4,0,0,0,0,0,0,1,0
Bianca Andreescu,0,0,0,0,0,0,0,0,0,0,0,0,0,0,0,Petra Martic,0,0,0,0,0,0,0,0,0,0,0,0,0,0,0,0,0,0
Aryna Sabalenka,0,0,0,0,0,94,49,99,43,5,105,68,97,53,9,Jessica Pegula,0,0,0,0,0,99,56,94,45,5,97,44,105,37,2,0,1,2
Amanda Anisimova,0,0,0,0,0,0,0,0,0,0,0,0,0,0,0,Danielle Collins,0,0,0,0,0,0,0,0,0,0,0,0,0,0,0,0,0,0
Ons Jabeur,0,0,0,0,0,82,44,86,45,2,61,33,61,36,3,Yulia Putintseva,0,0,0,0,0,86,41,82,38,1,61,25,61,28,0,0,1,1
Maria Sakkari,0,0,0,0,0,118,67,111,48,5,68,35,87,37,4,Cori Gauff,0,0,0,0,0,111,63,118,51,7,87,50,68,33,3,0,2,1
Jil Teichmann,0,0,0,0,0,0,0,0,0,0,0,0,0,0,0,Elena Rybakina,0,0,0,0,0,0,0,0,0,0,0,0,0,0,0,0,0,0
Daria Kasatkina,0,0,0,0,0,0,0,0,0,0,0,0,0,0,0,Paula Badosa,0,0,0,0,0,0,0,0,0,0,0,0,0,0,0,0,0,0
Iga Swiatek,0,0,0,0,0,0,0,0,0,0,0,0,0,0,0,Qinwen Zheng,0,0,0,0,0,0,0,0,0,0,0,0,0,0,0,0,0,0
Jessica Pegula,0,0,0,0,0,0,0,0,0,0,0,0,0,0,0,Irina Camelia Begu,0,0,0,0,0,0,0,0,0,0,0,0,0,0,0,0,0,0
Veronika Kudermetova,0,0,0,0,0,0,0,0,0,0,0,0,0,0,0,Madison Keys,0,0,0,0,0,0,0,0,0,0,0,0,0,0,0,0,0,0
Daria Kasatkina,0,0,0,0,0,81,54,82,38,3,0,0,0,0,0,Camila Giorgi,0,0,0,0,0,82,44,81,27,2,0,0,0,0,0,0,1,0
Martina Trevisan,0,0,0,0,0,0,0,0,0,0,0,0,0,0,0,Aliaksandra Sasnovich,0,0,0,0,0,0,0,0,0,0,0,0,0,0,0,0,0,0
Leylah Fernandez,0,0,0,0,0,0,0,0,0,0,0,0,0,0,0,Amanda Anisimova,0,0,0,0,0,0,0,0,0,0,0,0,0,0,0,0,0,0
Cori Gauff,104,54,85,36,8,0,0,0,0,0,0,0,0,0,0,Elise Mertens,85,49,104,50,4,0,0,0,0,0,0,0,0,0,0,1,0,0
Sloane Stephens,0,0,0,0,0,0,0,0,0,0,0,0,0,0,0,Jil Teichmann,0,0,0,0,0,0,0,0,0,0,0,0,0,0,0,0,0,0
Iga Swiatek,0,0,0,0,0,90,49,117,51,2,0,0,0,0,0,Jessica Pegula,0,0,0,0,0,117,66,90,41,6,0,0,0,0,0,0,1,0
Daria Kasatkina,0,0,0,0,0,74,50,70,32,2,0,0,0,0,0,Veronika Kudermetova,0,0,0,0,0,70,38,74,24,3,0,0,0,0,0,0,1,0
Martina Trevisan,0,0,0,0,0,0,0,0,0,0,0,0,0,0,0,Leylah Fernandez,0,0,0,0,0,0,0,0,0,0,0,0,0,0,0,0,0,0
Cori Gauff,0,0,0,0,0,50,30,49,10,5,0,0,0,0,0,Sloane Stephens,0,0,0,0,0,49,39,50,20,0,0,0,0,0,0,0,1,0
Iga Swiatek,69,29,72,28,2,0,0,0,0,0,0,0,0,0,0,Daria Kasatkina,72,44,69,40,4,0,0,0,0,0,0,0,0,0,0,1,0,0
Cori Gauff,0,0,0,0,0,0,0,0,0,0,96,46,90,43,3,Martina Trevisan,0,0,0,0,0,0,0,0,0,0,90,47,96,50,0,0,0,1
Iga Swiatek,0,0,0,0,0,0,0,0,0,0,74,49,72,30,1,Cori Gauff,0,0,0,0,0,0,0,0,0,0,72,42,74,25,7,0,0,1
Ajla Tomljanovic,88,49,90,38,1,173,100,169,73,3,0,0,0,0,0,Alize Cornet,90,52,88,39,4,169,96,173,73,7,0,0,0,0,0,1,2,0
Elena Rybakina,0,0,0,0,0,99,60,97,39,6,0,0,0,0,0,Petra Martic,0,0,0,0,0,97,58,99,39,2,0,0,0,0,0,0,1,0
Simona Halep,0,0,0,0,0,0,0,0,0,0,0,0,0,0,0,Paula Badosa,0,0,0,0,0,0,0,0,0,0,0,0,0,0,0,0,0,0
Amanda Anisimova,0,0,0,0,0,0,0,0,0,0,47,32,53,29,0,Harmony Tan,0,0,0,0,0,0,0,0,0,0,53,24,47,15,2,0,0,1
Marie Bouzkova,43,27,54,32,2,0,0,0,0,0,0,0,0,0,0,Caroline Garcia,54,22,43,16,4,0,0,0,0,0,0,0,0,0,0,1,0,0
Ons Jabeur,0,0,0,0,0,71,35,65,26,2,0,0,0,0,0,Elise Mertens,0,0,0,0,0,65,39,71,36,5,0,0,0,0,0,0,1,0
Tatjana Maria,0,0,0,0,0,0,0,0,0,0,0,0,0,0,0,Jelena Ostapenko,0,0,0,0,0,0,0,0,0,0,0,0,0,0,0,0,0,0
Jule Niemeier,0,0,0,0,0,0,0,0,0,0,0,0,0,0,0,Heather Watson,0,0,0,0,0,0,0,0,0,0,0,0,0,0,0,0,0,0
Elena Rybakina,0,0,0,0,0,0,0,0,0,0,53,33,45,25,2,Ajla Tomljanovic,0,0,0,0,0,0,0,0,0,0,45,20,53,20,0,0,0,1
Simona Halep,0,0,0,0,0,0,0,0,0,0,98,58,116,54,4,Amanda Anisimova,0,0,0,0,0,0,0,0,0,0,116,62,98,40,2,0,0,2
Ons Jabeur,0,0,0,0,0,0,0,0,0,0,0,0,0,0,0,Marie Bouzkova,0,0,0,0,0,0,0,0,0,0,0,0,0,0,0,0,0,0
Tatjana Maria,0,0,0,0,0,0,0,0,0,0,0,0,0,0,0,Jule Niemeier,0,0,0,0,0,0,0,0,0,0,0,0,0,0,0,0,0,0
Elena Rybakina,0,0,0,0,0,249,137,243,105,18,0,0,0,0,0,Simona Halep,0,0,0,0,0,243,138,249,112,4,0,0,0,0,0,0,3,0
Ons Jabeur,0,0,0,0,0,0,0,0,0,0,0,0,0,0,0,Tatjana Maria,0,0,0,0,0,0,0,0,0,0,0,0,0,0,0,0,0,0
Elena Rybakina,0,0,0,0,0,251,149,223,86,4,0,0,0,0,0,Ons Jabeur,0,0,0,0,0,223,137,251,102,9,0,0,0,0,0,0,3,0
Simona Halep,0,0,0,0,0,0,0,0,0,0,0,0,0,0,0,Beatriz Haddad Maia,0,0,0,0,0,0,0,0,0,0,0,0,0,0,0,0,0,0
Beatriz Haddad Maia,0,0,0,0,0,79,40,83,47,2,0,0,0,0,0,Karolina Pliskova,0,0,0,0,0,83,36,79,39,5,0,0,0,0,0,0,1,0
Simona Halep,0,0,0,0,0,0,0,0,0,0,0,0,0,0,0,Jessica Pegula,0,0,0,0,0,0,0,0,0,0,0,0,0,0,0,0,1,0
Beatriz Haddad Maia,0,0,0,0,0,0,0,0,0,0,0,0,0,0,0,Belinda Bencic,0,0,0,0,0,0,0,0,0,0,0,0,0,0,0,0,0,0
Karolina Pliskova,0,0,0,0,0,0,0,0,0,0,0,0,0,0,0,Qinwen Zheng,0,0,0,0,0,0,0,0,0,0,0,0,0,0,0,0,0,0
Jessica Pegula,0,0,0,0,0,0,0,0,0,0,0,0,0,0,0,Yulia Putintseva,0,0,0,0,0,0,0,0,0,0,0,0,0,0,0,0,0,0
Simona Halep,58,36,61,32,2,0,0,0,0,0,0,0,0,0,0,Cori Gauff,61,29,58,22,0,0,0,0,0,0,0,0,0,0,0,1,0,0
Beatriz Haddad Maia,0,0,0,0,0,0,0,0,0,0,0,0,0,0,0,Iga Swiatek,0,0,0,0,0,0,0,0,0,0,0,0,0,0,0,0,0,0
Belinda Bencic,0,0,0,0,0,0,0,0,0,0,0,0,0,0,0,Garbine Muguruza,0,0,0,0,0,0,0,0,0,0,0,0,0,0,0,0,0,0
Karolina Pliskova,0,0,0,0,0,64,39,49,8,6,62,41,63,27,2,Maria Sakkari,0,0,0,0,0,49,41,64,25,4,63,36,62,21,2,0,1,1
Qinwen Zheng,0,0,0,0,0,0,0,0,0,0,0,0,0,0,0,Bianca Andreescu,0,0,0,0,0,0,0,0,0,0,0,0,0,0,0,0,0,0
Jessica Pegula,0,0,0,0,0,96,66,103,53,5,0,0,0,0,0,Camila Giorgi,0,0,0,0,0,103,50,96,30,3,0,0,0,0,0,0,3,0
Yulia Putintseva,0,0,0,0,0,0,0,0,0,0,0,0,0,0,0,Alison Riske Amritraj,0,0,0,0,0,0,0,0,0,0,0,0,0,0,0,0,0,0
Cori Gauff,0,0,0,0,0,193,108,200,88,6,59,41,72,31,1,Aryna Sabalenka,0,0,0,0,0,200,112,193,85,10,72,41,59,18,4,0,2,1
Simona Halep,0,0,0,0,0,0,0,0,0,0,0,0,0,0,0,Jil Teichmann,0,0,0,0,0,0,0,0,0,0,0,0,0,0,0,0,0,0
Caroline Garcia,0,0,0,0,0,64,36,50,13,0,60,33,47,10,2,Petra Kvitova,0,0,0,0,0,50,37,64,28,3,47,37,60,27,5,0,1,1
Petra Kvitova,0,0,0,0,0,159,92,155,64,11,0,0,0,0,0,Madison Keys,0,0,0,0,0,155,91,159,67,11,0,0,0,0,0,0,2,0
Caroline Garcia,0,0,0,0,0,0,0,0,0,0,0,0,0,0,0,Aryna Sabalenka,0,0,0,0,0,0,0,0,0,0,0,0,0,0,0,0,0,0
Madison Keys,0,0,0,0,0,0,0,0,0,0,0,0,0,0,0,Elena Rybakina,0,0,0,0,0,0,0,0,0,0,0,0,0,0,0,0,0,0
Petra Kvitova,0,0,0,0,0,0,0,0,0,0,0,0,0,0,0,Ajla Tomljanovic,0,0,0,0,0,0,0,0,0,0,0,0,0,0,0,0,0,0
Caroline Garcia,59,30,44,12,7,0,0,0,0,0,0,0,0,0,0,Jessica Pegula,44,32,59,29,3,0,0,0,0,0,0,0,0,0,0,1,0,0
Aryna Sabalenka,0,0,0,0,0,0,0,0,0,0,50,37,56,27,3,Shuai Zhang,0,0,0,0,0,0,0,0,0,0,56,29,50,13,1,0,0,1
Madison Keys,0,0,0,0,0,0,0,0,0,0,68,34,56,19,6,Iga Swiatek,0,0,0,0,0,0,0,0,0,0,56,37,68,34,1,0,0,1
Elena Rybakina,0,0,0,0,0,0,0,0,0,0,0,0,0,0,0,Alison Riske Amritraj,0,0,0,0,0,0,0,0,0,0,0,0,0,0,0,0,0,0
Ajla Tomljanovic,0,0,0,0,0,163,93,187,71,8,0,0,0,0,0,Veronika Kudermetova,0,0,0,0,0,187,116,163,70,13,0,0,0,0,0,0,2,0
Petra Kvitova,47,31,58,29,0,123,72,143,73,3,0,0,0,0,0,Ons Jabeur,58,29,47,16,3,143,70,123,51,6,0,0,0,0,0,1,2,0
Jessica Pegula,0,0,0,0,0,0,0,0,0,0,0,0,0,0,0,Emma Raducanu,0,0,0,0,0,0,0,0,0,0,0,0,0,0,0,0,0,0
Caroline Garcia,0,0,0,0,0,166,93,188,75,6,99,56,74,28,6,Elise Mertens,0,0,0,0,0,188,113,166,73,16,74,46,99,43,2,0,3,1
Aryna Sabalenka,0,0,0,0,0,0,0,0,0,0,0,0,0,0,0,Shelby Rogers,0,0,0,0,0,0,0,0,0,0,0,0,0,0,0,0,0,0
Shuai Zhang,0,0,0,0,0,81,46,87,42,3,0,0,0,0,0,Anett Kontaveit,0,0,0,0,0,87,45,81,35,2,0,0,0,0,0,0,1,0
Iga Swiatek,0,0,0,0,0,0,0,0,0,0,0,0,0,0,0,Jule Niemeier,0,0,0,0,0,0,0,0,0,0,0,0,0,0,0,0,0,0
Jessica Pegula,0,0,0,0,0,126,63,120,47,2,0,0,0,0,0,Petra Kvitova,0,0,0,0,0,120,73,126,63,5,0,0,0,0,0,0,2,0
Karolina Pliskova,0,0,0,0,0,0,0,0,0,0,181,115,200,83,20,Victoria Azarenka,0,0,0,0,0,0,0,0,0,0,200,117,181,66,13,0,0,2
Aryna Sabalenka,0,0,0,0,0,90,64,128,68,11,0,0,0,0,0,Danielle Collins,0,0,0,0,0,128,60,90,26,6,0,0,0,0,0,0,2,0
Cori Gauff,0,0,0,0,0,0,0,0,0,0,0,0,0,0,0,Shuai Zhang,0,0,0,0,0,0,0,0,0,0,0,0,0,0,0,0,0,0
Caroline Garcia,0,0,0,0,0,0,0,0,0,0,0,0,0,0,0,Alison Riske Amritraj,0,0,0,0,0,0,0,0,0,0,0,0,0,0,0,0,0,0
Ons Jabeur,76,39,48,19,3,66,36,58,19,0,0,0,0,0,0,Veronika Kudermetova,48,29,76,37,4,58,39,66,30,4,0,0,0,0,0,1,1,0
Ajla Tomljanovic,0,0,0,0,0,62,40,63,31,2,0,0,0,0,0,Liudmila Samsonova,0,0,0,0,0,63,32,62,22,6,0,0,0,0,0,0,1,0
Iga Swiatek,0,0,0,0,0,90,49,117,51,2,0,0,0,0,0,Jessica Pegula,0,0,0,0,0,117,66,90,41,6,0,0,0,0,0,0,1,0
Aryna Sabalenka,100,66,83,21,18,0,0,0,0,0,0,0,0,0,0,Karolina Pliskova,83,62,100,34,14,0,0,0,0,0,0,0,0,0,0,1,1,0
Caroline Garcia,0,0,0,0,0,101,56,88,28,2,0,0,0,0,0,Cori Gauff,0,0,0,0,0,88,60,101,45,12,0,0,0,0,0,0,1,0
Ons Jabeur,0,0,0,0,0,0,0,0,0,0,0,0,0,0,0,Ajla Tomljanovic,0,0,0,0,0,0,0,0,0,0,0,0,0,0,0,0,0,0
Iga Swiatek,0,0,0,0,0,85,52,92,37,2,0,0,0,0,0,Aryna Sabalenka,0,0,0,0,0,92,55,85,33,8,0,0,0,0,0,0,1,0
Ons Jabeur,0,0,0,0,0,162,92,131,63,12,0,0,0,0,0,Caroline Garcia,0,0,0,0,0,131,68,162,70,5,0,0,0,0,0,0,2,0
Iga Swiatek,68,32,89,33,2,135,78,177,75,3,0,0,0,0,0,Ons Jabeur,89,56,68,36,9,177,102,135,57,20,0,0,0,0,0,1,2,0
Jessica Pegula,57,26,38,9,1,99,56,129,60,5,0,0,0,0,0,Maria Sakkari,38,29,57,31,6,129,69,99,43,4,0,0,0,0,0,1,1,0
Jessica Pegula,85,48,86,33,2,145,80,133,53,8,0,0,0,0,0,Victoria Azarenka,86,53,85,37,4,133,80,145,65,7,0,0,0,0,0,1,2,1
Maria Sakkari,53,35,44,23,4,45,23,57,32,6,0,0,0,0,0,Marie Bouzkova,44,21,53,18,0,57,25,45,22,2,0,0,0,0,0,1,1,0
Victoria Azarenka,0,0,0,0,0,0,0,0,0,0,0,0,0,0,0,Cori Gauff,0,0,0,0,0,0,0,0,0,0,0,0,0,0,0,0,0,0
Jessica Pegula,0,0,0,0,0,45,36,53,25,2,0,0,0,0,0,Sloane Stephens,0,0,0,0,0,53,28,45,9,0,0,0,0,0,0,0,1,0
Maria Sakkari,0,0,0,0,0,116,63,94,41,5,58,25,63,27,0,Veronika Kudermetova,0,0,0,0,0,94,53,116,53,7,63,36,58,33,1,0,1,1
Marie Bouzkova,0,0,0,0,0,58,41,54,28,6,0,0,0,0,0,Anna Kalinskaya,0,0,0,0,0,54,26,58,17,1,0,0,0,0,0,0,1,0
Victoria Azarenka,0,0,0,0,0,0,0,0,0,0,50,32,56,30,0,Madison Keys,0,0,0,0,0,0,0,0,0,0,56,26,50,18,0,0,0,1
Cori Gauff,0,0,0,0,0,0,0,0,0,0,96,46,90,43,3,Martina Trevisan,0,0,0,0,0,0,0,0,0,0,90,47,96,50,0,0,0,1
Jessica Pegula,0,0,0,0,0,0,0,0,0,0,0,0,0,0,0,Bianca Andreescu,0,0,0,0,0,0,0,0,0,0,0,0,0,0,0,0,0,0
Sloane Stephens,0,0,0,0,0,169,99,178,66,6,0,0,0,0,0,Caroline Garcia,0,0,0,0,0,178,112,169,70,12,0,0,0,0,0,0,2,0
Veronika Kudermetova,0,0,0,0,0,0,0,0,0,0,0,0,0,0,0,Jelena Ostapenko,0,0,0,0,0,0,0,0,0,0,0,0,0,0,0,0,0,0
Maria Sakkari,0,0,0,0,0,0,0,0,0,0,0,0,0,0,0,Danielle Collins,0,0,0,0,0,0,0,0,0,0,0,0,0,0,0,0,0,0
Anna Kalinskaya,0,0,0,0,0,0,0,0,0,0,0,0,0,0,0,Daria Kasatkina,0,0,0,0,0,0,0,0,0,0,0,0,0,0,0,0,0,0
Marie Bouzkova,0,0,0,0,0,0,0,0,0,0,0,0,0,0,0,Liudmila Samsonova,0,0,0,0,0,0,0,0,0,0,0,0,0,0,0,0,0,0
Iga Swiatek,0,0,0,0,0,0,0,0,0,0,74,49,72,30,1,Cori Gauff,0,0,0,0,0,0,0,0,0,0,72,42,74,25,7,0,0,1
Iga Swiatek,0,0,0,0,0,63,42,61,32,8,0,0,0,0,0,Caroline Garcia,0,0,0,0,0,61,29,63,21,2,0,0,0,0,0,0,1,0
Iga Swiatek,69,29,72,28,2,0,0,0,0,0,0,0,0,0,0,Daria Kasatkina,72,44,69,40,4,0,0,0,0,0,0,0,0,0,0,1,0,0
Caroline Garcia,0,0,0,0,0,101,56,88,28,2,0,0,0,0,0,Cori Gauff,0,0,0,0,0,88,60,101,45,12,0,0,0,0,0,0,1,0
Daria Kasatkina,0,0,0,0,0,55,30,45,28,1,0,0,0,0,0,Cori Gauff,0,0,0,0,0,45,17,55,25,2,0,0,0,0,0,0,1,0
Caroline Garcia,0,0,0,0,0,162,90,146,73,7,0,0,0,0,0,Daria Kasatkina,0,0,0,0,0,146,73,162,72,3,0,0,0,0,0,0,2,0
Ons Jabeur,0,0,0,0,0,77,43,73,31,4,0,0,0,0,0,Jessica Pegula,0,0,0,0,0,73,42,77,34,1,0,0,0,0,0,0,2,0
Maria Sakkari,0,0,0,0,0,66,46,97,44,7,0,0,0,0,0,Ons Jabeur,0,0,0,0,0,97,53,66,20,6,0,0,0,0,0,0,1,0
Aryna Sabalenka,68,45,65,27,3,58,28,48,19,4,107,64,100,41,5,Ons Jabeur,65,38,68,23,4,48,29,58,30,1,100,59,107,43,4,1,1,1
Maria Sakkari,38,29,57,31,6,129,69,99,43,4,0,0,0,0,0,Jessica Pegula,57,26,38,9,1,99,56,129,60,5,0,0,0,0,0,1,1,0
Aryna Sabalenka,0,0,0,0,0,94,49,99,43,5,105,68,97,53,9,Jessica Pegula,0,0,0,0,0,99,56,94,45,5,97,44,105,37,2,0,1,2
Maria Sakkari,0,0,0,0,0,449,251,474,180,23,0,0,0,0,0,Aryna Sabalenka,0,0,0,0,0,474,294,449,198,33,0,0,0,0,0,0,6,0
Aryna Sabalenka,0,0,0,0,0,92,55,85,33,8,0,0,0,0,0,Iga Swiatek,0,0,0,0,0,85,52,92,37,2,0,0,0,0,0,0,1,0
Caroline Garcia,0,0,0,0,0,0,0,0,0,0,0,0,0,0,0,Maria Sakkari,0,0,0,0,0,0,0,0,0,0,0,0,0,0,0,0,0,0
Caroline Garcia,0,0,0,0,0,0,0,0,0,0,0,0,0,0,0,Aryna Sabalenka,0,0,0,0,0,0,0,0,0,0,0,0,0,0,0,0,0,0
