name1,grass_pts_served1,grass_service_pts_won1,grass_pts_received1,grass_receiving_pts_won1,grass_aces1,hard_pts_served1,hard_service_pts_won1,hard_pts_received1,hard_receiving_pts_won1,hard_aces1,clay_pts_served1,clay_service_pts_won1,clay_pts_received1,clay_receiving_pts_won1,clay_aces1,name2,grass_pts_served2,grass_service_pts_won2,grass_pts_received2,grass_receiving_pts_won2,grass_aces2,hard_pts_served2,hard_service_pts_won2,hard_pts_received2,hard_receiving_pts_won2,hard_aces2,clay_pts_served2,clay_service_pts_won2,clay_pts_received2,clay_receiving_pts_won2,clay_aces2,grass_sample_size,hard_sample_size,clay_sample_size
Rafael Nadal,0,0,0,0,0,0,0,0,0,0,78,55,78,36,1,Kei Nishikori,0,0,0,0,0,0,0,0,0,0,78,42,78,23,0,0,0,1
Grigor Dimitrov,0,0,0,0,0,53,30,48,11,7,0,0,0,0,0,Roberto Bautista Agut,0,0,0,0,0,48,37,53,23,1,0,0,0,0,0,0,1,0
Andy Murray,0,0,0,0,0,0,0,0,0,0,0,0,0,0,0,Stephane Robert,0,0,0,0,0,0,0,0,0,0,0,0,0,0,0,0,0,0
Roger Federer,0,0,0,0,0,158,109,175,60,6,100,53,76,20,0,Jo-Wilfried Tsonga,0,0,0,0,0,175,115,158,49,20,76,56,100,47,2,0,1,1
Tomas Berdych,124,81,121,43,11,178,121,177,72,12,133,88,135,54,15,Kevin Anderson,121,78,124,43,19,177,105,178,57,19,135,81,133,45,17,1,2,2
David Ferrer,0,0,0,0,0,62,37,60,20,1,0,0,0,0,0,Florian Mayer,0,0,0,0,0,60,40,62,25,6,0,0,0,0,0,0,1,0
Stan Wawrinka,0,0,0,0,0,99,58,102,38,11,70,39,84,36,1,Tommy Robredo,0,0,0,0,0,102,64,99,41,7,84,48,70,31,3,0,1,1
Novak Djokovic,0,0,0,0,0,124,89,152,72,12,40,32,40,22,3,Fabio Fognini,0,0,0,0,0,152,80,124,35,4,40,18,40,8,1,0,2,1
Rafael Nadal,0,0,0,0,0,87,56,83,33,4,87,53,71,26,2,Grigor Dimitrov,0,0,0,0,0,83,50,87,31,12,71,45,87,34,8,0,1,1
Roger Federer,0,0,0,0,0,171,105,157,46,5,0,0,0,0,0,Andy Murray,0,0,0,0,0,157,111,171,66,21,0,0,0,0,0,0,1,0
Tomas Berdych,0,0,0,0,0,140,96,158,55,21,0,0,0,0,0,David Ferrer,0,0,0,0,0,158,103,140,44,9,0,0,0,0,0,0,2,0
Stan Wawrinka,0,0,0,0,0,518,308,445,149,31,0,0,0,0,0,Novak Djokovic,0,0,0,0,0,445,296,518,210,20,0,0,0,0,0,0,4,0
Rafael Nadal,0,0,0,0,0,202,143,236,96,6,42,30,53,29,1,Roger Federer,0,0,0,0,0,236,140,202,59,14,53,24,42,12,3,0,3,1
Stan Wawrinka,0,0,0,0,0,221,153,217,81,26,88,56,79,25,5,Tomas Berdych,0,0,0,0,0,217,136,221,68,19,79,54,88,32,8,0,3,1
Stan Wawrinka,0,0,0,0,0,135,90,162,52,9,141,74,117,29,8,Rafael Nadal,0,0,0,0,0,162,110,135,45,4,117,88,141,67,8,0,2,2
Alexandr Dolgopolov,0,0,0,0,0,0,0,0,0,0,0,0,0,0,0,Fabio Fognini,0,0,0,0,0,0,0,0,0,0,0,0,0,0,0,0,0,0
Milos Raonic,0,0,0,0,0,0,0,0,0,0,0,0,0,0,0,Andy Murray,0,0,0,0,0,0,0,0,0,0,0,0,0,0,0,0,0,0
Kevin Anderson,0,0,0,0,0,120,77,82,21,21,0,0,0,0,0,Stan Wawrinka,0,0,0,0,0,82,61,120,43,14,0,0,0,0,0,0,1,0
Roger Federer,78,56,85,31,15,100,61,93,36,10,0,0,0,0,0,Tommy Haas,85,54,78,22,6,93,57,100,39,10,0,0,0,0,0,1,1,0
John Isner,0,0,0,0,0,0,0,0,0,0,0,0,0,0,0,Fernando Verdasco,0,0,0,0,0,0,0,0,0,0,0,0,0,0,0,0,0,0
Ernests Gulbis,0,0,0,0,0,40,32,47,24,5,0,0,0,0,0,Roberto Bautista Agut,0,0,0,0,0,47,23,40,8,0,0,0,0,0,0,0,1,0
Julien Benneteau,74,51,58,7,12,48,31,48,26,6,0,0,0,0,0,Feliciano Lopez,58,51,74,23,19,48,22,48,17,3,0,0,0,0,0,1,1,0
Novak Djokovic,0,0,0,0,0,0,0,0,0,0,0,0,0,0,0,Marin Cilic,0,0,0,0,0,0,0,0,0,0,0,0,0,0,0,0,0,0
Alexandr Dolgopolov,0,0,0,0,0,0,0,0,0,0,0,0,0,0,0,Milos Raonic,0,0,0,0,0,0,0,0,0,0,0,0,0,0,0,0,0,0
Roger Federer,0,0,0,0,0,62,42,65,27,7,0,0,0,0,0,Kevin Anderson,0,0,0,0,0,65,38,62,20,9,0,0,0,0,0,0,1,0
John Isner,0,0,0,0,0,98,69,106,39,17,93,50,73,20,6,Ernests Gulbis,0,0,0,0,0,106,67,98,29,8,73,53,93,43,11,0,1,1
Novak Djokovic,0,0,0,0,0,0,0,0,0,0,0,0,0,0,0,Julien Benneteau,0,0,0,0,0,0,0,0,0,0,0,0,0,0,0,0,0,0
Roger Federer,0,0,0,0,0,0,0,0,0,0,0,0,0,0,0,Alexandr Dolgopolov,0,0,0,0,0,0,0,0,0,0,0,0,0,0,0,0,0,0
Novak Djokovic,0,0,0,0,0,200,145,204,71,20,0,0,0,0,0,John Isner,0,0,0,0,0,204,133,200,55,21,0,0,0,0,0,0,3,0
Novak Djokovic,0,0,0,0,0,193,123,192,80,16,0,0,0,0,0,Roger Federer,0,0,0,0,0,192,112,193,70,10,0,0,0,0,0,0,2,0
Rafael Nadal,0,0,0,0,0,79,44,98,47,3,147,98,175,82,5,Fabio Fognini,0,0,0,0,0,98,51,79,35,3,175,93,147,49,3,0,1,2
Milos Raonic,0,0,0,0,0,0,0,0,0,0,0,0,0,0,0,Benjamin Becker,0,0,0,0,0,0,0,0,0,0,0,0,0,0,0,0,0,0
Alexandr Dolgopolov,0,0,0,0,0,0,0,0,0,0,0,0,0,0,0,Stan Wawrinka,0,0,0,0,0,0,0,0,0,0,0,0,0,0,0,0,0,1
Tomas Berdych,0,0,0,0,0,64,38,67,32,6,0,0,0,0,0,John Isner,0,0,0,0,0,67,35,64,26,9,0,0,0,0,0,0,1,0
Roger Federer,0,0,0,0,0,64,42,67,31,6,0,0,0,0,0,Richard Gasquet,0,0,0,0,0,67,36,64,22,0,0,0,0,0,0,0,1,0
Kei Nishikori,0,0,0,0,0,157,76,150,53,2,0,0,0,0,0,David Ferrer,0,0,0,0,0,150,97,157,81,7,0,0,0,0,0,0,2,0
Andy Murray,82,57,85,33,5,0,0,0,0,0,0,0,0,0,0,Jo-Wilfried Tsonga,85,52,82,25,10,0,0,0,0,0,0,0,0,0,0,1,0,0
Novak Djokovic,0,0,0,0,0,0,0,0,0,0,0,0,0,0,0,Tommy Robredo,0,0,0,0,0,0,0,0,0,0,0,0,0,0,0,0,0,0
Rafael Nadal,0,0,0,0,0,40,33,46,22,4,42,29,57,30,4,Milos Raonic,0,0,0,0,0,46,24,40,7,4,57,27,42,13,6,0,1,1
Tomas Berdych,0,0,0,0,0,66,45,53,21,9,0,0,0,0,0,Alexandr Dolgopolov,0,0,0,0,0,53,32,66,21,2,0,0,0,0,0,0,1,0
Kei Nishikori,0,0,0,0,0,0,0,0,0,0,80,50,65,19,1,Roger Federer,0,0,0,0,0,0,0,0,0,0,65,46,80,30,7,0,0,1
Novak Djokovic,105,55,105,41,4,134,96,131,43,8,0,0,0,0,0,Andy Murray,105,64,105,50,9,131,88,134,38,7,0,0,0,0,0,1,1,0
Rafael Nadal,0,0,0,0,0,242,162,248,96,12,45,37,48,20,0,Tomas Berdych,0,0,0,0,0,248,152,242,80,24,48,28,45,8,5,0,4,1
Novak Djokovic,0,0,0,0,0,0,0,0,0,0,0,0,0,0,0,Kei Nishikori,0,0,0,0,0,0,0,0,0,0,0,0,0,0,0,0,0,0
Novak Djokovic,0,0,0,0,0,304,200,336,126,25,236,144,238,92,7,Rafael Nadal,0,0,0,0,0,336,210,304,104,11,238,146,236,92,8,0,4,2
Rafael Nadal,0,0,0,0,0,0,0,0,0,0,0,0,0,0,0,Andreas Seppi,0,0,0,0,0,0,0,0,0,0,0,0,0,0,0,0,0,0
David Ferrer,0,0,0,0,0,92,56,99,40,1,0,0,0,0,0,Grigor Dimitrov,0,0,0,0,0,99,59,92,36,3,0,0,0,0,0,0,1,0
Stan Wawrinka,0,0,0,0,0,57,38,54,28,9,65,51,55,18,4,Nicolas Almagro,0,0,0,0,0,54,26,57,19,3,55,37,65,14,7,0,1,1
Milos Raonic,0,0,0,0,0,0,0,0,0,0,104,74,117,42,13,Tommy Robredo,0,0,0,0,0,0,0,0,0,0,117,75,104,30,9,0,0,1
Jo-Wilfried Tsonga,0,0,0,0,0,0,0,0,0,0,0,0,0,0,0,Fabio Fognini,0,0,0,0,0,0,0,0,0,0,0,0,0,0,0,0,0,0
Roger Federer,0,0,0,0,0,0,0,0,0,0,0,0,0,0,0,Lukas Rosol,0,0,0,0,0,0,0,0,0,0,0,0,0,0,0,0,0,0
Guillermo Garcia Lopez,0,0,0,0,0,0,0,0,0,0,0,0,0,0,0,Tomas Berdych,0,0,0,0,0,0,0,0,0,0,0,0,0,0,0,0,0,0
Novak Djokovic,0,0,0,0,0,0,0,0,0,0,0,0,0,0,0,Pablo Carreno Busta,0,0,0,0,0,0,0,0,0,0,0,0,0,0,0,0,0,0
David Ferrer,0,0,0,0,0,131,74,107,42,4,328,160,343,139,3,Rafael Nadal,0,0,0,0,0,107,65,131,57,4,343,204,328,168,8,0,2,4
Stan Wawrinka,0,0,0,0,0,62,50,59,15,10,0,0,0,0,0,Milos Raonic,0,0,0,0,0,59,44,62,12,11,0,0,0,0,0,0,1,0
Roger Federer,0,0,0,0,0,158,109,175,60,6,100,53,76,20,0,Jo-Wilfried Tsonga,0,0,0,0,0,175,115,158,49,20,76,56,100,47,2,0,1,1
Novak Djokovic,0,0,0,0,0,0,0,0,0,0,0,0,0,0,0,Guillermo Garcia Lopez,0,0,0,0,0,0,0,0,0,0,0,0,0,0,0,0,0,0
Stan Wawrinka,0,0,0,0,0,102,62,95,41,14,116,74,131,52,6,David Ferrer,0,0,0,0,0,95,54,102,40,0,131,79,116,42,4,0,1,2
Roger Federer,0,0,0,0,0,192,112,193,70,10,0,0,0,0,0,Novak Djokovic,0,0,0,0,0,193,123,192,80,16,0,0,0,0,0,0,2,0
Stan Wawrinka,0,0,0,0,0,119,69,104,42,6,0,0,0,0,0,Roger Federer,0,0,0,0,0,104,62,119,50,5,0,0,0,0,0,0,1,0
Rafael Nadal,0,0,0,0,0,0,0,0,0,0,0,0,0,0,0,Jarkko Nieminen,0,0,0,0,0,0,0,0,0,0,0,0,0,0,0,0,0,0
Tomas Berdych,0,0,0,0,0,0,0,0,0,0,0,0,0,0,0,Grigor Dimitrov,0,0,0,0,0,0,0,0,0,0,0,0,0,0,0,0,0,0
Roberto Bautista Agut,0,0,0,0,0,0,0,0,0,0,0,0,0,0,0,Lukasz Kubot,0,0,0,0,0,0,0,0,0,0,0,0,0,0,0,0,0,0
Santiago Giraldo,0,0,0,0,0,0,0,0,0,0,0,0,0,0,0,Andy Murray,0,0,0,0,0,0,0,0,0,0,0,0,0,0,0,0,0,0
Kei Nishikori,0,0,0,0,0,0,0,0,0,0,0,0,0,0,0,Milos Raonic,0,0,0,0,0,0,0,0,0,0,0,0,0,0,0,0,0,0
Feliciano Lopez,0,0,0,0,0,0,0,0,0,0,0,0,0,0,0,Dominic Thiem,0,0,0,0,0,0,0,0,0,0,0,0,0,0,0,0,0,0
David Ferrer,0,0,0,0,0,0,0,0,0,0,0,0,0,0,0,John Isner,0,0,0,0,0,0,0,0,0,0,0,0,0,0,0,0,0,0
Ernests Gulbis,0,0,0,0,0,0,0,0,0,0,0,0,0,0,0,Marin Cilic,0,0,0,0,0,0,0,0,0,0,0,0,0,0,0,0,0,0
Rafael Nadal,0,0,0,0,0,242,162,248,96,12,45,37,48,20,0,Tomas Berdych,0,0,0,0,0,248,152,242,80,24,48,28,45,8,5,0,4,1
Roberto Bautista Agut,0,0,0,0,0,0,0,0,0,0,0,0,0,0,0,Santiago Giraldo,0,0,0,0,0,0,0,0,0,0,0,0,0,0,0,0,0,0
Kei Nishikori,0,0,0,0,0,165,114,184,77,11,0,0,0,0,0,Feliciano Lopez,0,0,0,0,0,184,107,165,51,26,0,0,0,0,0,0,3,0
David Ferrer,0,0,0,0,0,71,47,99,46,1,0,0,0,0,0,Ernests Gulbis,0,0,0,0,0,99,53,71,24,8,0,0,0,0,0,0,1,0
Rafael Nadal,0,0,0,0,0,0,0,0,0,0,0,0,0,0,0,Roberto Bautista Agut,0,0,0,0,0,0,0,0,0,0,0,0,0,0,0,0,0,0
Kei Nishikori,0,0,0,0,0,157,76,150,53,2,0,0,0,0,0,David Ferrer,0,0,0,0,0,150,97,157,81,7,0,0,0,0,0,0,2,0
Rafael Nadal,0,0,0,0,0,0,0,0,0,0,78,55,78,36,1,Kei Nishikori,0,0,0,0,0,0,0,0,0,0,78,42,78,23,0,0,0,1
Rafael Nadal,0,0,0,0,0,0,0,0,0,0,44,31,50,25,0,Mikhail Youzhny,0,0,0,0,0,0,0,0,0,0,50,25,44,13,1,0,0,1
Andy Murray,0,0,0,0,0,0,0,0,0,0,0,0,0,0,0,Jurgen Melzer,0,0,0,0,0,0,0,0,0,0,0,0,0,0,0,0,0,0
Tommy Haas,0,0,0,0,0,0,0,0,0,0,0,0,0,0,0,Stan Wawrinka,0,0,0,0,0,0,0,0,0,0,0,0,0,0,0,0,0,0
Grigor Dimitrov,0,0,0,0,0,0,0,0,0,0,0,0,0,0,0,Tomas Berdych,0,0,0,0,0,0,0,0,0,0,0,0,0,0,0,0,0,0
Milos Raonic,0,0,0,0,0,80,60,91,25,12,0,0,0,0,0,Jo-Wilfried Tsonga,0,0,0,0,0,91,66,80,20,7,0,0,0,0,0,0,1,0
Jeremy Chardy,0,0,0,0,0,0,0,0,0,0,0,0,0,0,0,Ivan Dodig,0,0,0,0,0,0,0,0,0,0,0,0,0,0,0,0,0,0
David Ferrer,0,0,0,0,0,71,47,99,46,1,0,0,0,0,0,Ernests Gulbis,0,0,0,0,0,99,53,71,24,8,0,0,0,0,0,0,1,0
Novak Djokovic,0,0,0,0,0,0,0,0,0,0,141,94,116,40,2,Philipp Kohlschreiber,0,0,0,0,0,0,0,0,0,0,116,76,141,47,4,0,0,1
Rafael Nadal,0,0,0,0,0,0,0,0,0,0,0,0,0,0,0,Andy Murray,0,0,0,0,0,0,0,0,0,0,0,0,0,0,0,0,0,0
Grigor Dimitrov,0,0,0,0,0,84,61,88,22,15,0,0,0,0,0,Tommy Haas,0,0,0,0,0,88,66,84,23,5,0,0,0,0,0,0,1,0
Milos Raonic,0,0,0,0,0,132,101,173,66,29,0,0,0,0,0,Jeremy Chardy,0,0,0,0,0,173,107,132,31,10,0,0,0,0,0,0,2,0
Novak Djokovic,0,0,0,0,0,115,88,160,78,10,0,0,0,0,0,David Ferrer,0,0,0,0,0,160,82,115,27,2,0,0,0,0,0,0,2,0
Rafael Nadal,0,0,0,0,0,87,56,83,33,4,87,53,71,26,2,Grigor Dimitrov,0,0,0,0,0,83,50,87,31,12,71,45,87,34,8,0,1,1
Novak Djokovic,0,0,0,0,0,0,0,0,0,0,0,0,0,0,0,Milos Raonic,0,0,0,0,0,0,0,0,0,0,0,0,0,0,0,0,0,1
Novak Djokovic,0,0,0,0,0,304,200,336,126,25,236,144,238,92,7,Rafael Nadal,0,0,0,0,0,336,210,304,104,11,238,146,236,92,8,0,4,2
Rafael Nadal,0,0,0,0,0,0,0,0,0,0,0,0,0,0,0,Dusan Lajovic,0,0,0,0,0,0,0,0,0,0,0,0,0,0,0,0,0,0
David Ferrer,0,0,0,0,0,88,52,76,29,2,71,52,86,45,1,Kevin Anderson,0,0,0,0,0,76,47,88,36,6,86,41,71,19,5,0,1,1
Gael Monfils,0,0,0,0,0,0,0,0,0,0,0,0,0,0,0,Guillermo Garcia Lopez,0,0,0,0,0,0,0,0,0,0,0,0,0,0,0,0,0,0
Andy Murray,135,95,148,56,14,0,0,0,0,0,0,0,0,0,0,Fernando Verdasco,148,92,135,40,11,0,0,0,0,0,0,0,0,0,0,1,0,0
Tomas Berdych,0,0,0,0,0,64,38,67,32,6,0,0,0,0,0,John Isner,0,0,0,0,0,67,35,64,26,9,0,0,0,0,0,0,1,0
Ernests Gulbis,0,0,0,0,0,0,0,0,0,0,0,0,0,0,0,Roger Federer,0,0,0,0,0,0,0,0,0,0,0,0,0,0,0,0,0,0
Milos Raonic,0,0,0,0,0,0,0,0,0,0,0,0,0,0,0,Marcel Granollers,0,0,0,0,0,0,0,0,0,0,0,0,0,0,0,0,0,0
Novak Djokovic,0,0,0,0,0,98,72,122,62,14,0,0,0,0,0,Jo-Wilfried Tsonga,0,0,0,0,0,122,60,98,26,6,0,0,0,0,0,0,2,0
Rafael Nadal,0,0,0,0,0,107,65,131,57,4,343,204,328,168,8,David Ferrer,0,0,0,0,0,131,74,107,42,4,328,160,343,139,3,0,2,4
Andy Murray,0,0,0,0,0,0,0,0,0,0,0,0,0,0,0,Gael Monfils,0,0,0,0,0,0,0,0,0,0,0,0,0,0,0,0,0,0
Ernests Gulbis,0,0,0,0,0,99,65,98,28,19,0,0,0,0,0,Tomas Berdych,0,0,0,0,0,98,70,99,34,8,0,0,0,0,0,0,1,0
Novak Djokovic,0,0,0,0,0,0,0,0,0,0,0,0,0,0,0,Milos Raonic,0,0,0,0,0,0,0,0,0,0,0,0,0,0,0,0,0,1
Rafael Nadal,0,0,0,0,0,0,0,0,0,0,0,0,0,0,0,Andy Murray,0,0,0,0,0,0,0,0,0,0,0,0,0,0,0,0,0,0
Novak Djokovic,0,0,0,0,0,0,0,0,0,0,0,0,0,0,0,Ernests Gulbis,0,0,0,0,0,0,0,0,0,0,0,0,0,0,0,0,0,0
Rafael Nadal,0,0,0,0,0,336,210,304,104,11,238,146,236,92,8,Novak Djokovic,0,0,0,0,0,304,200,336,126,25,236,144,238,92,7,0,4,2
Novak Djokovic,0,0,0,0,0,98,72,122,62,14,0,0,0,0,0,Jo-Wilfried Tsonga,0,0,0,0,0,122,60,98,26,6,0,0,0,0,0,0,2,0
Marin Cilic,0,0,0,0,0,0,0,0,0,0,0,0,0,0,0,Jeremy Chardy,0,0,0,0,0,0,0,0,0,0,0,0,0,0,0,0,0,0
Andy Murray,0,0,0,0,0,0,0,0,0,0,0,0,0,0,0,Kevin Anderson,0,0,0,0,0,0,0,0,0,0,0,0,0,0,0,0,0,0
Grigor Dimitrov,0,0,0,0,0,0,0,0,0,0,0,0,0,0,0,Leonardo Mayer,0,0,0,0,0,0,0,0,0,0,0,0,0,0,0,0,0,0
Stan Wawrinka,0,0,0,0,0,71,55,84,33,19,102,61,94,35,15,Feliciano Lopez,0,0,0,0,0,84,51,71,16,5,94,59,102,41,8,0,1,1
Roger Federer,0,0,0,0,0,86,54,125,47,5,0,0,0,0,0,Tommy Robredo,0,0,0,0,0,125,78,86,32,6,0,0,0,0,0,0,1,0
Milos Raonic,0,0,0,0,0,0,0,0,0,0,0,0,0,0,0,Kei Nishikori,0,0,0,0,0,0,0,0,0,0,0,0,0,0,0,0,0,0
Nick Kyrgios,0,0,0,0,0,0,0,0,0,0,0,0,0,0,0,Rafael Nadal,0,0,0,0,0,0,0,0,0,0,0,0,0,0,0,0,0,0
Novak Djokovic,0,0,0,0,0,0,0,0,0,0,0,0,0,0,0,Marin Cilic,0,0,0,0,0,0,0,0,0,0,0,0,0,0,0,0,0,0
Grigor Dimitrov,0,0,0,0,0,137,82,160,57,6,0,0,0,0,0,Andy Murray,0,0,0,0,0,160,103,137,55,16,0,0,0,0,0,0,2,0
Roger Federer,0,0,0,0,0,104,62,119,50,5,0,0,0,0,0,Stan Wawrinka,0,0,0,0,0,119,69,104,42,6,0,0,0,0,0,0,1,0
Milos Raonic,0,0,0,0,0,0,0,0,0,0,0,0,0,0,0,Nick Kyrgios,0,0,0,0,0,0,0,0,0,0,0,0,0,0,0,0,0,0
Novak Djokovic,0,0,0,0,0,55,40,56,24,1,196,131,215,90,7,Grigor Dimitrov,0,0,0,0,0,56,32,55,15,5,215,125,196,65,13,0,1,2
Roger Federer,0,0,0,0,0,78,66,96,35,14,0,0,0,0,0,Milos Raonic,0,0,0,0,0,96,61,78,12,19,0,0,0,0,0,0,1,0
Novak Djokovic,0,0,0,0,0,193,123,192,80,16,0,0,0,0,0,Roger Federer,0,0,0,0,0,192,112,193,70,10,0,0,0,0,0,0,2,0
Jo-Wilfried Tsonga,0,0,0,0,0,122,60,98,26,6,0,0,0,0,0,Novak Djokovic,0,0,0,0,0,98,72,122,62,14,0,0,0,0,0,0,2,0
Andy Murray,0,0,0,0,0,83,55,75,37,6,0,0,0,0,0,Richard Gasquet,0,0,0,0,0,75,38,83,28,2,0,0,0,0,0,0,1,0
Kevin Anderson,0,0,0,0,0,120,77,82,21,21,0,0,0,0,0,Stan Wawrinka,0,0,0,0,0,82,61,120,43,14,0,0,0,0,0,0,1,0
Grigor Dimitrov,0,0,0,0,0,0,0,0,0,0,62,32,51,16,1,Tommy Robredo,0,0,0,0,0,0,0,0,0,0,51,35,62,30,1,0,0,1
Milos Raonic,0,0,0,0,0,0,0,0,0,0,58,41,50,22,15,Julien Benneteau,0,0,0,0,0,0,0,0,0,0,50,28,58,17,2,0,0,1
Feliciano Lopez,0,0,0,0,0,79,49,59,12,15,0,0,0,0,0,Tomas Berdych,0,0,0,0,0,59,47,79,30,8,0,0,0,0,0,0,1,0
David Ferrer,125,91,148,59,7,0,0,0,0,0,0,0,0,0,0,Ivan Dodig,148,89,125,34,14,0,0,0,0,0,0,0,0,0,0,1,0,0
Roger Federer,0,0,0,0,0,0,0,0,0,0,0,0,0,0,0,Marin Cilic,0,0,0,0,0,0,0,0,0,0,0,0,0,0,0,0,0,0
Jo-Wilfried Tsonga,85,52,82,25,10,0,0,0,0,0,0,0,0,0,0,Andy Murray,82,57,85,33,5,0,0,0,0,0,0,0,0,0,0,1,0,0
Grigor Dimitrov,0,0,0,0,0,0,0,0,0,0,0,0,0,0,0,Kevin Anderson,0,0,0,0,0,0,0,0,0,0,0,0,0,0,0,0,0,0
Feliciano Lopez,0,0,0,0,0,192,121,157,36,13,0,0,0,0,0,Milos Raonic,0,0,0,0,0,157,121,192,71,48,0,0,0,0,0,0,2,0
Roger Federer,0,0,0,0,0,0,0,0,0,0,0,0,0,0,0,David Ferrer,0,0,0,0,0,0,0,0,0,0,0,0,0,0,0,0,0,0
Jo-Wilfried Tsonga,0,0,0,0,0,0,0,0,0,0,0,0,0,0,0,Grigor Dimitrov,0,0,0,0,0,0,0,0,0,0,0,0,0,0,0,0,0,0
Roger Federer,0,0,0,0,0,0,0,0,0,0,0,0,0,0,0,Feliciano Lopez,0,0,0,0,0,0,0,0,0,0,0,0,0,0,0,0,0,0
Jo-Wilfried Tsonga,0,0,0,0,0,175,115,158,49,20,76,56,100,47,2,Roger Federer,0,0,0,0,0,158,109,175,60,6,100,53,76,20,0,0,1,1
Tommy Robredo,0,0,0,0,0,0,0,0,0,0,0,0,0,0,0,Novak Djokovic,0,0,0,0,0,0,0,0,0,0,0,0,0,0,0,0,0,0
David Ferrer,0,0,0,0,0,59,34,62,22,1,0,0,0,0,0,Mikhail Youzhny,0,0,0,0,0,62,40,59,25,5,0,0,0,0,0,0,1,0
Stan Wawrinka,0,0,0,0,0,0,0,0,0,0,0,0,0,0,0,Marin Cilic,0,0,0,0,0,0,0,0,0,0,0,0,0,0,0,0,0,0
Julien Benneteau,0,0,0,0,0,165,101,158,52,17,0,0,0,0,0,Jerzy Janowicz,0,0,0,0,0,158,106,165,64,29,0,0,0,0,0,0,2,0
Milos Raonic,0,0,0,0,0,0,0,0,0,0,0,0,0,0,0,Steve Johnson,0,0,0,0,0,0,0,0,0,0,0,0,0,0,0,0,0,0
Fabio Fognini,0,0,0,0,0,0,0,0,0,0,0,0,0,0,0,Yen Hsun Lu,0,0,0,0,0,0,0,0,0,0,0,0,0,0,0,0,0,0
Andy Murray,0,0,0,0,0,0,0,0,0,0,0,0,0,0,0,John Isner,0,0,0,0,0,0,0,0,0,0,0,0,0,0,0,0,0,0
Roger Federer,0,0,0,0,0,102,67,104,31,3,0,0,0,0,0,Gael Monfils,0,0,0,0,0,104,73,102,35,15,0,0,0,0,0,0,1,0
David Ferrer,0,0,0,0,0,0,0,0,0,0,118,85,117,61,2,Tommy Robredo,0,0,0,0,0,0,0,0,0,0,117,56,118,33,4,0,0,2
Julien Benneteau,0,0,0,0,0,59,36,59,29,3,0,0,0,0,0,Stan Wawrinka,0,0,0,0,0,59,30,59,23,0,0,0,0,0,0,0,1,0
Milos Raonic,0,0,0,0,0,0,0,0,0,0,0,0,0,0,0,Fabio Fognini,0,0,0,0,0,0,0,0,0,0,0,0,0,0,0,0,1,0
Roger Federer,0,0,0,0,0,171,105,157,46,5,0,0,0,0,0,Andy Murray,0,0,0,0,0,157,111,171,66,21,0,0,0,0,0,0,1,0
David Ferrer,0,0,0,0,0,50,36,51,26,4,0,0,0,0,0,Julien Benneteau,0,0,0,0,0,51,25,50,14,2,0,0,0,0,0,0,1,0
Roger Federer,0,0,0,0,0,78,66,96,35,14,0,0,0,0,0,Milos Raonic,0,0,0,0,0,96,61,78,12,19,0,0,0,0,0,0,1,0
Roger Federer,0,0,0,0,0,0,0,0,0,0,0,0,0,0,0,David Ferrer,0,0,0,0,0,0,0,0,0,0,0,0,0,0,0,0,0,0
Novak Djokovic,0,0,0,0,0,0,0,0,0,0,141,94,116,40,2,Philipp Kohlschreiber,0,0,0,0,0,0,0,0,0,0,116,76,141,47,4,0,0,1
Andy Murray,82,57,85,33,5,0,0,0,0,0,0,0,0,0,0,Jo-Wilfried Tsonga,85,52,82,25,10,0,0,0,0,0,0,0,0,0,0,1,0,0
Stan Wawrinka,0,0,0,0,0,99,58,102,38,11,70,39,84,36,1,Tommy Robredo,0,0,0,0,0,102,64,99,41,7,84,48,70,31,3,0,1,1
Kei Nishikori,0,0,0,0,0,0,0,0,0,0,0,0,0,0,0,Milos Raonic,0,0,0,0,0,0,0,0,0,0,0,0,0,0,0,0,0,0
Tomas Berdych,0,0,0,0,0,0,0,0,0,0,0,0,0,0,0,Dominic Thiem,0,0,0,0,0,0,0,0,0,0,0,0,0,0,0,0,0,0
Marin Cilic,0,0,0,0,0,0,0,0,0,0,0,0,0,0,0,Gilles Simon,0,0,0,0,0,0,0,0,0,0,0,0,0,0,0,0,0,0
Gael Monfils,0,0,0,0,0,0,0,0,0,0,0,0,0,0,0,Grigor Dimitrov,0,0,0,0,0,0,0,0,0,0,0,0,0,0,0,0,0,0
Roger Federer,0,0,0,0,0,0,0,0,0,0,0,0,0,0,0,Roberto Bautista Agut,0,0,0,0,0,0,0,0,0,0,0,0,0,0,0,0,0,0
Novak Djokovic,105,55,105,41,4,134,96,131,43,8,0,0,0,0,0,Andy Murray,105,64,105,50,9,131,88,134,38,7,0,0,0,0,0,1,1,0
Kei Nishikori,0,0,0,0,0,0,0,0,0,0,0,0,0,0,0,Stan Wawrinka,0,0,0,0,0,0,0,0,0,0,0,0,0,0,0,0,0,0
Marin Cilic,86,61,71,21,8,0,0,0,0,0,0,0,0,0,0,Tomas Berdych,71,50,86,25,5,0,0,0,0,0,0,0,0,0,0,1,0,0
Roger Federer,0,0,0,0,0,102,67,104,31,3,0,0,0,0,0,Gael Monfils,0,0,0,0,0,104,73,102,35,15,0,0,0,0,0,0,1,0
Kei Nishikori,0,0,0,0,0,0,0,0,0,0,0,0,0,0,0,Novak Djokovic,0,0,0,0,0,0,0,0,0,0,0,0,0,0,0,0,0,0
Marin Cilic,0,0,0,0,0,0,0,0,0,0,0,0,0,0,0,Roger Federer,0,0,0,0,0,0,0,0,0,0,0,0,0,0,0,0,0,0
Marin Cilic,0,0,0,0,0,48,27,54,17,12,0,0,0,0,0,Kei Nishikori,0,0,0,0,0,54,37,48,21,4,0,0,0,0,0,0,1,0
Novak Djokovic,0,0,0,0,0,0,0,0,0,0,0,0,0,0,0,Mikhail Kukushkin,0,0,0,0,0,0,0,0,0,0,0,0,0,0,0,0,0,0
David Ferrer,0,0,0,0,0,98,48,110,54,4,0,0,0,0,0,Andy Murray,0,0,0,0,0,110,56,98,50,2,0,0,0,0,0,0,1,0
Roger Federer,0,0,0,0,0,0,0,0,0,0,0,0,0,0,0,Roberto Bautista Agut,0,0,0,0,0,0,0,0,0,0,0,0,0,0,0,0,0,0
Julien Benneteau,0,0,0,0,0,0,0,0,0,0,0,0,0,0,0,Jack Sock,0,0,0,0,0,0,0,0,0,0,0,0,0,0,0,0,0,0
Tomas Berdych,0,0,0,0,0,93,73,115,35,11,0,0,0,0,0,Ivo Karlovic,0,0,0,0,0,115,80,93,20,23,0,0,0,0,0,0,1,0
Gilles Simon,0,0,0,0,0,0,0,0,0,0,0,0,0,0,0,Malek Jaziri,0,0,0,0,0,0,0,0,0,0,0,0,0,0,0,0,0,0
Mikhail Youzhny,0,0,0,0,0,0,0,0,0,0,119,68,102,41,4,Juan Monaco,0,0,0,0,0,0,0,0,0,0,102,61,119,51,7,0,0,1
Feliciano Lopez,0,0,0,0,0,0,0,0,0,0,0,0,0,0,0,John Isner,0,0,0,0,0,0,0,0,0,0,0,0,0,0,0,0,0,0
Novak Djokovic,0,0,0,0,0,115,88,160,78,10,0,0,0,0,0,David Ferrer,0,0,0,0,0,160,82,115,27,2,0,0,0,0,0,0,2,0
Roger Federer,0,0,0,0,0,69,36,57,21,7,79,64,83,34,7,Julien Benneteau,0,0,0,0,0,57,36,69,33,6,83,49,79,15,2,0,1,1
Gilles Simon,0,0,0,0,0,125,67,118,44,6,0,0,0,0,0,Tomas Berdych,0,0,0,0,0,118,74,125,58,18,0,0,0,0,0,0,1,0
Feliciano Lopez,0,0,0,0,0,0,0,0,0,0,0,0,0,0,0,Mikhail Youzhny,0,0,0,0,0,0,0,0,0,0,0,0,0,0,0,0,0,0
Roger Federer,0,0,0,0,0,192,112,193,70,10,0,0,0,0,0,Novak Djokovic,0,0,0,0,0,193,123,192,80,16,0,0,0,0,0,0,2,0
Gilles Simon,243,149,201,50,9,0,0,0,0,0,0,0,0,0,0,Feliciano Lopez,201,151,243,94,37,0,0,0,0,0,0,0,0,0,0,2,0,0
Roger Federer,0,0,0,0,0,0,0,0,0,0,161,113,216,98,12,Gilles Simon,0,0,0,0,0,0,0,0,0,0,216,118,161,48,6,0,0,2
Novak Djokovic,0,0,0,0,0,86,60,103,42,4,0,0,0,0,0,Gael Monfils,0,0,0,0,0,103,61,86,26,9,0,0,0,0,0,0,1,0
Andy Murray,0,0,0,0,0,160,103,137,55,16,0,0,0,0,0,Grigor Dimitrov,0,0,0,0,0,137,82,160,57,6,0,0,0,0,0,0,2,0
David Ferrer,0,0,0,0,0,0,0,0,0,0,102,64,100,38,5,Fernando Verdasco,0,0,0,0,0,0,0,0,0,0,100,62,102,38,4,0,1,1
Kei Nishikori,0,0,0,0,0,167,103,164,51,5,0,0,0,0,0,Jo-Wilfried Tsonga,0,0,0,0,0,164,113,167,64,28,0,0,0,0,0,0,2,0
Tomas Berdych,0,0,0,0,0,59,47,79,30,8,0,0,0,0,0,Feliciano Lopez,0,0,0,0,0,79,49,59,12,15,0,0,0,0,0,0,1,0
Kevin Anderson,0,0,0,0,0,120,77,82,21,21,0,0,0,0,0,Stan Wawrinka,0,0,0,0,0,82,61,120,43,14,0,0,0,0,0,0,1,0
Milos Raonic,0,0,0,0,0,0,0,0,0,0,0,0,0,0,0,Roberto Bautista Agut,0,0,0,0,0,0,0,0,0,0,0,0,0,0,0,0,0,0
Roger Federer,0,0,0,0,0,0,0,0,0,0,0,0,0,0,0,Lucas Pouille,0,0,0,0,0,0,0,0,0,0,0,0,0,0,0,0,0,0
Novak Djokovic,105,55,105,41,4,134,96,131,43,8,0,0,0,0,0,Andy Murray,105,64,105,50,9,131,88,134,38,7,0,0,0,0,0,1,1,0
Kei Nishikori,0,0,0,0,0,157,76,150,53,2,0,0,0,0,0,David Ferrer,0,0,0,0,0,150,97,157,81,7,0,0,0,0,0,0,2,0
Tomas Berdych,124,81,121,43,11,178,121,177,72,12,133,88,135,54,15,Kevin Anderson,121,78,124,43,19,177,105,178,57,19,135,81,133,45,17,1,2,2
Milos Raonic,0,0,0,0,0,96,61,78,12,19,0,0,0,0,0,Roger Federer,0,0,0,0,0,78,66,96,35,14,0,0,0,0,0,0,1,0
Novak Djokovic,0,0,0,0,0,0,0,0,0,0,0,0,0,0,0,Kei Nishikori,0,0,0,0,0,0,0,0,0,0,0,0,0,0,0,0,0,0
Milos Raonic,0,0,0,0,0,149,108,132,33,36,0,0,0,0,0,Tomas Berdych,0,0,0,0,0,132,99,149,41,12,0,0,0,0,0,0,2,0
Novak Djokovic,0,0,0,0,0,0,0,0,0,0,0,0,0,0,0,Milos Raonic,0,0,0,0,0,0,0,0,0,0,0,0,0,0,0,0,0,1
Novak Djokovic,0,0,0,0,0,445,296,518,210,20,0,0,0,0,0,Stan Wawrinka,0,0,0,0,0,518,308,445,149,31,0,0,0,0,0,0,4,0
Novak Djokovic,89,63,99,39,16,164,117,175,75,18,90,58,106,39,8,Tomas Berdych,99,60,89,26,6,175,100,164,47,13,106,67,90,32,9,1,3,1
Novak Djokovic,0,0,0,0,0,0,0,0,0,0,0,0,0,0,0,Marin Cilic,0,0,0,0,0,0,0,0,0,0,0,0,0,0,0,0,0,0
Stan Wawrinka,0,0,0,0,0,221,153,217,81,26,88,56,79,25,5,Tomas Berdych,0,0,0,0,0,217,136,221,68,19,79,54,88,32,8,0,3,1
Stan Wawrinka,0,0,0,0,0,0,0,0,0,0,0,0,0,0,0,Marin Cilic,0,0,0,0,0,0,0,0,0,0,0,0,0,0,0,0,0,0
Tomas Berdych,71,50,86,25,5,0,0,0,0,0,0,0,0,0,0,Marin Cilic,86,61,71,21,8,0,0,0,0,0,0,0,0,0,0,1,0,0
Roger Federer,0,0,0,0,0,0,0,0,0,0,65,46,80,30,7,Kei Nishikori,0,0,0,0,0,0,0,0,0,0,80,50,65,19,1,0,0,1
Roger Federer,0,0,0,0,0,171,105,157,46,5,0,0,0,0,0,Andy Murray,0,0,0,0,0,157,111,171,66,21,0,0,0,0,0,0,1,0
Kei Nishikori,0,0,0,0,0,34,17,30,8,1,0,0,0,0,0,Andy Murray,0,0,0,0,0,30,22,34,17,4,0,0,0,0,0,0,1,0
Kei Nishikori,0,0,0,0,0,157,76,150,53,2,0,0,0,0,0,David Ferrer,0,0,0,0,0,150,97,157,81,7,0,0,0,0,0,0,2,0
Roger Federer,0,0,0,0,0,78,66,96,35,14,0,0,0,0,0,Milos Raonic,0,0,0,0,0,96,61,78,12,19,0,0,0,0,0,0,1,0
Andy Murray,0,0,0,0,0,0,0,0,0,0,0,0,0,0,0,Milos Raonic,0,0,0,0,0,0,0,0,0,0,0,0,0,0,0,0,0,0
Roger Federer,0,0,0,0,0,104,62,119,50,5,0,0,0,0,0,Stan Wawrinka,0,0,0,0,0,119,69,104,42,6,0,0,0,0,0,0,1,0
Novak Djokovic,0,0,0,0,0,0,0,0,0,0,0,0,0,0,0,Kei Nishikori,0,0,0,0,0,0,0,0,0,0,0,0,0,0,0,0,0,0
Novak Djokovic,0,0,0,0,0,193,123,192,80,16,0,0,0,0,0,Roger Federer,0,0,0,0,0,192,112,193,70,10,0,0,0,0,0,0,2,0
